675 675 675 675 675 675 675 675 675 675 675 675 675 675 675 675 675 675 675 675 675 675 675 675 675 675 675 675 675 675 675 675 675 675 675 675 675 675 675 675 675 675 675 675 675 675 675 675 675 675 
675 675 675 675 675 675 675 675 675 675 675 675 675 675 675 675 675 675 675 675 675 675 675 675 675 675 675 675 675 675 675 675 675 675 675 675 675 675 675 675 675 675 675 675 675 675 675 675 675 675 
675 675 675 675 675 675 675 675 675 675 675 675 675 675 675 675 675 675 675 675 675 675 675 675 675 675 675 675 675 675 675 675 675 675 675 675 675 675 675 675 675 675 675 675 675 675 675 675 675 675 
675 675 675 675 675 675 675 675 675 675 675 675 675 675 675 675 675 675 675 675 675 675 675 675 675 675 675 675 675 675 675 675 675 675 675 675 675 675 675 675 675 675 675 675 675 675 675 675 675 675 
675 675 675 675 675 675 675 675 675 675 675 675 675 675 675 675 675 675 675 675 675 675 675 675 675 675 675 675 675 675 675 675 675 675 675 675 675 675 675 675 675 675 675 675 675 675 675 675 675 675 
675 675 675 675 675 675 675 675 675 675 675 675 675 675 675 675 675 675 675 675 675 675 675 675 675 675 675 675 675 675 675 675 675 675 675 675 675 675 675 675 675 675 675 675 675 675 675 675 675 675 
675 675 675 675 675 675 675 675 675 675 675 675 675 675 675 675 675 675 675 675 675 675 675 675 675 675 675 675 675 675 675 675 675 675 675 675 675 675 675 675 675 675 675 675 675 675 675 675 675 675 
675 675 675 675 675 675 675 675 675 675 675 675 675 675 675 675 675 675 675 675 675 675 675 675 675 675 675 675 675 675 675 675 675 675 675 675 675 675 675 675 675 675 675 675 675 675 675 675 675 675 
675 675 675 675 675 675 675 675 675 675 675 675 675 675 675 675 675 675 675 675 675 675 675 675 675 675 675 675 675 675 675 675 675 675 675 675 675 675 675 675 675 675 675 675 675 675 675 675 675 675 
675 675 675 675 675 675 765 765 765 765 765 765 765 765 765 765 765 765 765 765 765 765 765 765 765 765 765 765 765 765 765 765 765 765 765 765 765 765 765 765 765 765 765 765 675 675 675 675 675 675 
675 675 675 675 675 675 765 765 765 765 765 765 765 765 765 765 765 765 765 765 765 765 765 765 765 765 765 765 765 765 765 765 765 765 765 765 765 765 765 765 765 765 765 765 675 675 675 675 675 675 
675 675 675 675 675 675 765 765 790 790 765 765 765 765 765 765 765 765 765 765 765 765 765 765 765 765 765 765 765 765 765 765 765 765 765 765 765 765 765 765 785 765 765 765 675 675 675 675 675 675 
675 675 675 675 675 675 765 785 765 765 785 765 765 765 765 765 765 765 765 765 765 765 765 765 765 765 765 765 765 765 765 765 765 765 765 765 765 765 765 778 792 778 765 765 675 675 675 675 675 675 
675 675 675 675 675 675 765 792 778 798 792 765 765 765 765 765 765 778 778 741 778 778 778 778 778 778 778 778 778 778 765 765 765 765 765 765 765 765 765 778 778 778 765 765 675 675 675 675 675 675 
675 675 675 675 675 675 765 778 805 797 808 765 765 765 765 765 765 778 765 765 765 765 765 765 765 765 765 765 765 778 765 765 765 765 765 765 765 765 765 778 778 778 765 765 675 675 675 675 675 675 
675 675 675 675 675 675 765 778 778 778 778 765 765 765 765 765 765 778 765 765 765 765 765 765 765 765 765 765 765 778 778 765 765 765 765 765 765 765 765 778 778 765 765 765 675 675 675 675 675 675 
675 675 675 675 675 675 765 765 765 765 739 765 765 765 765 765 765 778 765 765 765 765 765 765 765 765 765 765 765 778 778 779 765 765 765 765 765 765 765 765 778 765 765 765 675 675 675 675 675 675 
675 675 675 675 675 675 765 765 765 765 778 765 765 765 765 765 765 778 765 765 765 765 765 765 765 765 765 765 765 778 778 778 778 778 778 778 778 778 778 778 778 765 765 765 675 675 675 675 675 675 
675 675 675 675 675 675 765 765 765 765 778 778 765 765 765 778 778 778 765 765 765 765 765 765 765 765 765 765 765 778 778 780 765 765 765 765 765 765 765 765 765 765 765 765 675 675 675 675 675 675 
675 675 675 675 675 675 765 765 765 765 765 778 778 778 778 778 765 765 765 765 765 765 765 765 765 765 765 765 765 778 778 765 765 765 765 765 765 765 765 765 765 765 765 765 675 675 675 675 675 675 
675 675 675 675 675 675 765 765 765 765 765 765 765 765 765 765 765 765 765 765 765 765 765 765 765 765 765 765 765 778 795 765 765 765 765 765 765 765 765 765 765 765 765 765 675 675 675 675 675 675 
675 675 675 675 675 675 765 765 765 765 765 765 765 765 765 765 765 765 765 765 765 765 765 765 765 765 765 765 778 778 778 778 765 765 765 765 765 765 765 765 765 765 765 765 675 675 675 675 675 675 
675 675 675 675 675 675 765 765 765 765 765 765 765 765 765 765 765 765 765 765 765 765 765 765 765 765 770 778 778 778 778 778 778 765 765 765 765 765 765 765 765 765 765 765 675 675 675 675 675 675 
675 675 675 675 675 675 765 765 765 765 765 765 765 765 765 765 765 765 765 765 765 765 765 765 765 765 778 778 778 778 778 778 778 778 765 765 765 765 765 765 765 765 765 765 675 675 675 675 675 675 
675 675 675 675 675 675 765 765 765 765 765 765 765 765 765 765 765 765 765 765 765 765 765 765 765 778 778 778 778 798 799 800 778 778 778 765 765 765 765 765 765 765 765 765 675 675 675 675 675 675 
675 675 675 675 675 675 765 765 778 778 778 778 765 765 765 765 765 765 795 778 778 778 778 778 765 778 778 778 801 802 803 804 778 778 778 795 778 778 778 778 778 765 765 765 675 675 675 675 675 675 
675 675 675 675 675 675 765 765 778 778 742 778 778 778 778 778 778 778 778 765 765 765 765 778 778 795 778 778 805 806 807 808 778 778 778 765 765 765 765 765 778 765 765 765 675 675 675 675 675 675 
675 675 675 675 675 675 765 765 778 778 778 778 762 765 765 765 765 765 765 765 765 765 765 765 765 778 778 778 778 778 778 778 778 778 778 765 765 765 765 765 778 765 765 765 675 675 675 675 675 675 
675 675 675 675 675 675 765 765 765 765 765 765 765 765 765 765 765 765 765 765 765 765 765 765 765 762 778 778 778 778 778 778 778 778 765 765 765 765 765 765 778 778 765 765 675 675 675 675 675 675 
675 675 675 675 675 675 765 765 765 765 765 765 765 765 765 765 765 765 765 765 765 765 765 765 765 765 765 778 778 778 778 778 765 765 765 765 765 765 765 765 765 778 795 765 675 675 675 675 675 675 
675 675 675 675 675 675 765 765 765 765 765 765 765 765 765 765 765 765 765 765 765 765 765 765 765 765 765 765 790 778 795 788 765 765 765 765 765 765 765 765 765 765 778 765 675 675 675 675 675 675 
675 675 675 675 675 675 765 765 765 765 765 765 765 765 765 765 765 765 765 765 765 765 765 765 765 765 765 765 765 778 778 765 765 765 765 765 765 765 765 765 765 765 765 765 675 675 675 675 675 675 
675 675 675 675 675 675 765 765 765 765 765 765 765 765 765 765 765 765 765 765 765 765 765 765 765 765 765 765 765 778 778 765 765 765 765 765 765 765 765 765 765 765 765 765 675 675 675 675 675 675 
675 675 675 675 675 675 765 765 765 765 765 765 765 765 765 765 765 765 765 765 765 765 765 765 766 765 765 765 765 778 778 765 765 765 765 765 765 778 778 778 778 778 765 765 675 675 675 675 675 675 
675 675 675 675 675 675 765 765 765 765 765 765 765 765 765 765 778 778 778 778 795 778 778 778 793 765 765 765 765 778 778 765 765 765 765 765 765 778 765 765 765 778 765 765 675 675 675 675 675 675 
675 675 675 675 675 675 765 765 765 765 765 765 765 765 765 765 778 765 765 765 765 765 765 765 778 765 765 765 765 778 778 765 765 765 765 765 765 778 765 765 765 778 765 765 675 675 675 675 675 675 
675 675 675 675 675 675 765 765 765 765 765 765 765 765 765 765 778 765 765 765 765 765 765 765 778 765 765 765 765 778 778 765 765 765 765 779 765 795 765 765 765 791 765 765 675 675 675 675 675 675 
675 675 675 675 675 675 765 765 765 765 765 765 765 765 765 765 778 765 765 765 765 765 765 765 778 778 785 765 765 778 778 765 765 785 765 778 778 778 765 765 765 765 765 765 675 675 675 675 675 675 
675 675 675 675 675 675 765 765 765 765 765 765 765 765 765 778 795 778 765 765 765 765 765 765 778 778 792 778 765 778 778 765 765 792 778 778 778 778 765 786 765 765 765 765 675 675 675 675 675 675 
675 675 675 675 675 675 765 765 765 765 765 765 765 765 765 797 778 778 765 765 765 765 765 765 765 765 778 778 778 795 778 778 778 778 778 778 778 778 778 793 765 765 765 765 675 675 675 675 675 675 
675 675 675 675 675 675 765 765 765 765 765 765 765 765 765 778 778 778 765 765 765 765 765 765 765 765 765 765 765 765 765 780 765 778 778 778 778 778 765 765 765 765 765 765 675 675 675 675 675 675 
675 675 675 675 675 675 765 765 765 765 765 765 765 765 765 765 765 765 765 765 765 765 765 765 765 765 765 765 765 765 765 765 765 765 765 778 765 765 765 765 765 765 765 765 675 675 675 675 675 675 
675 675 675 675 675 675 765 765 765 765 765 765 765 765 765 765 765 765 765 765 765 765 765 765 765 765 765 765 765 765 765 765 765 765 765 778 765 765 765 765 765 765 765 765 675 675 675 675 675 675 
675 675 675 675 675 675 765 765 765 765 765 765 765 765 765 765 765 765 765 765 765 765 765 765 765 765 765 765 765 765 765 765 765 765 765 765 765 765 765 765 765 765 765 765 675 675 675 675 675 675 
675 675 675 675 675 675 675 675 675 675 675 675 675 675 675 675 675 675 675 675 675 675 675 675 675 675 675 675 675 675 675 675 675 675 675 675 675 675 675 675 675 675 675 675 675 675 675 675 675 675 
675 675 675 675 675 675 675 675 675 675 675 675 675 675 675 675 675 675 675 675 675 675 675 675 675 675 675 675 675 675 675 675 675 675 675 675 675 675 675 675 675 675 675 675 675 675 675 675 675 675 
675 675 675 675 675 675 675 675 675 675 675 675 675 675 675 675 675 675 675 675 675 675 675 675 675 675 675 675 675 675 675 675 675 675 675 675 675 675 675 675 675 675 675 675 675 675 675 675 675 675 
675 675 675 675 675 675 675 675 675 675 675 675 675 675 675 675 675 675 675 675 675 675 675 675 675 675 675 675 675 675 675 675 675 675 675 675 675 675 675 675 675 675 675 675 675 675 675 675 675 675 
675 675 675 675 675 675 675 675 675 675 675 675 675 675 675 675 675 675 675 675 675 675 675 675 675 675 675 675 675 675 675 675 675 675 675 675 675 675 675 675 675 675 675 675 675 675 675 675 675 675 
675 675 675 675 675 675 675 675 675 675 675 675 675 675 675 675 675 675 675 675 675 675 675 675 675 675 675 675 675 675 675 675 675 675 675 675 675 675 675 675 675 675 675 675 675 675 675 675 675 675 
