1 1 1 1 1 1 1 1 1 1 1 1 1 1 1 1 1 1 1 1 1 1 1 1 1 1 1 1 1 1 1 1 1 1 1 1 1 1 1 1 1 1 1 1 1 1 1 1 1 1 1 1 1 1 1 1 1 1 1 1 1 1 1 1 1 1 1 1 1 1 1 1 1 1 1 1 1 1 1 1 1 1 1 1 1 1 1 1 1 1 1 1 1 1 1 1 1 1 1 1 
1 1 1 1 1 1 1 1 1 1 1 1 1 1 1 1 1 1 1 1 1 1 1 1 1 1 1 33 30 30 30 30 39 1 1 1 1 1 1 1 1 1 1 1 1 1 1 1 1 1 1 1 1 1 1 1 1 1 1 1 1 1 1 1 1 1 1 1 1 1 1 1 1 1 1 1 1 1 1 1 1 1 1 1 1 1 1 1 1 1 1 1 1 1 1 1 1 1 1 1 
1 1 1 1 1 1 1 1 1 1 1 1 33 30 30 30 30 30 39 1 1 1 33 30 30 30 30 53 306 15 306 306 53 1 1 1 1 1 1 1 1 1 1 1 1 1 1 1 1 1 1 1 1 1 1 1 1 1 1 1 1 1 1 1 1 1 1 1 1 1 1 1 1 1 1 1 1 1 1 1 1 1 1 1 1 1 1 1 1 1 1 1 1 1 1 1 1 1 1 1 
1 1 1 1 1 1 1 1 1 1 1 1 53 306 306 306 306 306 53 1 1 1 53 306 306 306 15 53 306 306 306 16 35 30 30 30 39 1 1 1 1 1 1 1 1 1 1 33 30 30 30 30 30 30 30 30 30 30 30 30 30 30 39 1 1 1 1 1 1 1 1 1 1 1 33 30 30 30 30 30 30 30 30 30 30 30 30 39 1 1 1 1 1 1 1 1 1 1 1 1 
1 1 1 1 1 1 1 1 1 1 1 1 53 306 306 306 306 306 53 1 1 1 53 306 16 306 306 53 306 15 306 306 306 306 306 306 53 1 1 1 1 1 1 1 1 1 1 53 306 306 306 15 306 306 16 306 306 306 15 306 306 306 53 1 1 1 1 1 1 1 1 1 1 1 53 306 306 306 306 16 306 306 306 306 306 306 306 53 306 306 306 306 44 1 1 1 1 1 1 1 
1 1 1 1 1 1 1 1 1 1 37 33 41 306 15 306 306 306 35 30 30 30 32 42 306 306 36 32 42 306 306 306 306 306 306 306 35 30 30 30 30 30 30 30 30 30 30 41 306 306 306 306 306 306 306 306 306 306 306 306 16 306 35 30 30 30 30 30 30 30 30 30 30 30 32 42 306 306 15 306 306 306 306 15 306 16 306 35 30 30 30 39 43 1 1 1 1 1 1 1 
1 1 1 1 1 1 1 1 1 1 37 53 306 306 306 15 306 306 306 306 306 306 306 306 306 306 306 306 306 306 306 306 306 306 306 15 306 306 306 306 306 306 306 306 306 306 306 306 16 306 306 306 306 306 306 15 306 306 306 306 306 306 306 16 306 306 306 15 306 306 306 306 306 306 306 16 306 306 306 306 306 306 15 306 306 306 306 306 306 306 306 53 44 1 1 1 1 1 1 1 
1 1 1 1 1 1 1 1 1 1 37 53 254 257 192 192 192 192 192 192 192 192 192 192 192 192 192 192 192 192 192 192 192 192 192 192 192 192 192 192 192 192 192 192 192 192 192 192 192 192 192 192 192 192 192 192 192 192 192 192 192 192 254 257 199 199 4 4 4 4 4 4 4 4 4 4 4 4 4 4 4 4 4 4 4 4 4 4 4 4 4 53 44 1 1 1 1 1 1 1 
1 1 1 1 1 1 1 1 1 1 37 53 255 258 254 257 192 192 254 257 254 257 192 192 4 4 199 199 199 199 199 199 254 257 254 257 199 199 199 199 199 199 199 199 199 199 199 192 199 199 199 199 4 4 4 4 4 4 4 4 192 192 255 258 199 199 4 4 4 4 4 4 4 4 4 4 4 4 4 4 4 4 4 4 4 4 4 4 4 4 4 53 44 1 1 1 1 1 1 1 
1 1 1 1 1 1 1 1 1 1 37 53 260 261 255 258 254 257 255 258 255 258 254 257 4 4 199 4 4 192 192 192 255 258 255 258 4 4 4 4 4 4 4 4 4 4 4 199 4 4 4 4 4 4 4 4 4 4 4 4 4 4 260 261 199 199 4 4 4 4 4 4 4 4 4 4 4 4 4 4 4 4 4 4 4 4 4 4 4 4 4 53 44 1 1 1 1 1 1 1 
1 1 1 1 1 1 1 1 1 1 37 53 254 257 260 261 255 258 260 261 260 261 255 258 192 192 199 4 4 192 4 4 260 261 260 261 4 4 4 4 4 4 4 4 4 4 254 257 4 4 4 4 4 4 4 4 4 4 4 4 213 4 4 254 257 199 4 4 4 4 4 4 4 4 4 4 4 4 4 4 4 4 4 4 4 4 4 4 4 4 4 53 44 1 1 1 1 1 1 1 
1 1 1 1 1 1 1 1 1 1 37 53 255 258 254 257 260 261 4 4 4 4 260 261 4 4 4 4 4 4 4 4 4 192 4 208 4 4 4 4 4 4 4 4 4 4 255 258 192 192 4 4 4 4 4 4 4 4 213 213 213 213 199 255 258 199 4 4 4 4 4 4 4 4 4 4 4 4 4 4 4 4 4 4 4 4 4 4 4 4 4 53 44 1 1 1 1 1 1 1 
1 1 1 1 1 1 1 1 1 1 37 53 260 261 255 258 4 4 4 4 4 4 4 192 192 192 192 4 4 4 4 4 4 199 4 254 257 192 192 192 192 4 4 4 4 4 260 261 4 192 192 192 192 254 257 4 4 4 4 4 213 4 4 260 261 199 4 4 4 4 4 4 4 4 4 4 4 4 4 4 4 4 4 4 4 4 4 4 4 4 4 53 44 1 1 1 1 1 1 1 
1 1 1 1 1 1 1 1 1 1 37 53 254 257 260 261 4 4 4 4 4 4 4 4 4 4 4 4 4 4 4 4 4 4 4 255 258 4 4 4 254 257 4 4 4 4 254 257 4 4 4 4 4 255 258 4 4 4 4 4 213 4 4 254 257 199 4 4 4 4 4 4 4 4 4 4 4 4 4 4 4 4 4 4 4 4 4 4 4 4 4 53 44 1 1 1 1 1 1 1 
1 1 1 1 1 1 1 1 1 1 37 53 255 258 4 4 4 4 4 4 254 257 4 4 4 4 254 257 4 4 192 192 192 192 192 260 261 4 4 4 255 258 4 4 4 4 255 258 4 4 4 4 4 260 261 4 4 4 4 4 213 4 4 255 258 199 199 4 4 4 4 4 4 4 4 4 4 4 4 4 4 4 4 4 4 4 4 4 4 4 4 53 44 1 1 1 1 1 1 1 
1 1 1 1 1 1 1 1 1 1 37 53 260 261 4 4 4 4 4 4 255 258 254 257 254 257 255 258 4 4 4 254 257 4 4 4 192 4 4 4 260 261 192 4 254 257 260 261 4 4 4 192 192 192 4 4 4 192 192 192 192 192 192 260 261 199 199 4 4 4 4 4 4 4 4 4 4 4 4 4 4 4 4 4 4 4 4 4 4 4 4 53 44 1 1 1 1 1 1 1 
1 1 1 1 1 1 1 1 1 1 37 53 254 257 4 4 4 4 254 257 260 261 255 258 255 258 260 261 4 4 4 255 258 4 4 4 192 4 4 4 4 4 4 4 255 258 254 257 4 4 192 254 257 4 4 4 4 4 192 4 4 4 192 254 257 199 199 4 4 4 4 4 4 4 4 4 4 4 4 4 4 4 4 4 4 4 4 4 4 4 4 53 44 1 1 1 1 1 1 1 
1 1 1 1 1 1 1 1 1 1 37 53 255 258 4 4 4 4 255 258 254 257 260 261 260 261 4 4 4 4 4 260 261 4 4 4 192 192 192 192 4 4 4 4 260 261 255 258 4 4 4 255 258 4 4 4 4 254 257 4 4 4 4 255 258 199 199 4 4 4 4 4 4 4 4 4 4 4 4 4 4 4 4 4 4 4 4 4 4 4 4 53 44 1 1 1 1 1 1 1 
1 1 1 1 1 1 1 1 1 1 37 53 260 261 4 4 4 4 260 261 255 258 55 54 58 193 4 4 4 4 4 254 257 254 257 4 4 4 213 4 4 4 4 4 4 4 260 261 4 4 4 260 261 4 4 4 4 255 258 4 192 4 192 260 261 4 199 4 4 4 4 4 4 4 4 4 4 4 4 4 4 4 4 4 4 4 4 4 4 4 4 53 44 1 1 1 1 1 1 1 
1 1 1 1 1 1 1 1 1 1 37 53 254 257 4 4 4 254 257 4 256 259 56 1 59 193 193 193 193 254 257 255 258 255 258 4 4 4 254 257 4 4 4 4 4 4 254 257 4 4 4 192 4 4 4 4 4 260 261 4 192 192 254 257 254 257 4 4 4 4 4 4 4 4 4 4 4 4 4 4 4 4 4 4 4 4 4 4 4 4 4 53 44 1 1 1 1 1 1 1 
1 1 1 1 1 1 1 1 1 1 37 53 255 258 4 4 4 255 258 254 257 193 56 1 63 54 58 4 193 255 258 260 261 260 261 4 4 4 255 258 4 4 4 4 4 4 255 258 4 4 4 192 4 4 4 4 4 4 199 4 192 4 255 258 255 258 4 4 4 4 4 4 4 4 4 4 4 4 4 4 4 4 4 4 4 4 4 4 4 4 4 53 44 1 1 1 1 1 1 1 
1 1 1 1 1 1 1 1 1 1 37 53 260 261 4 4 4 260 261 255 258 4 56 1 1 1 59 4 4 256 259 254 257 254 257 4 4 4 260 261 4 4 213 213 213 213 260 261 4 4 4 192 254 257 192 4 4 192 192 4 254 257 260 261 260 261 4 4 4 4 4 4 4 4 4 4 4 4 4 4 4 4 4 4 4 4 4 4 4 4 4 53 44 1 1 1 1 1 1 1 
1 1 1 1 1 1 1 1 1 1 37 53 254 257 4 4 4 254 257 256 259 4 56 1 1 1 59 4 4 4 4 255 258 255 258 4 4 4 213 213 199 199 213 199 199 199 254 257 4 4 4 4 255 258 4 4 4 4 192 192 255 258 4 4 4 4 4 4 4 4 4 4 4 4 4 4 4 4 4 4 4 4 4 4 4 4 4 4 4 4 4 53 44 1 1 1 1 1 1 1 
1 1 1 1 1 1 1 1 1 1 37 53 255 258 205 4 4 255 258 254 257 4 57 61 61 61 60 4 4 4 4 256 259 260 261 4 4 4 213 4 199 199 213 199 213 4 255 258 4 192 192 192 260 261 4 4 4 4 4 4 260 261 192 213 213 4 4 4 4 4 4 4 4 4 4 4 4 4 4 4 4 4 4 4 4 4 4 4 4 4 4 53 44 1 1 1 1 1 1 1 
1 1 1 1 1 1 1 1 1 1 37 53 256 259 195 4 195 256 259 255 258 4 4 4 4 4 4 4 4 4 4 4 254 257 192 192 4 4 213 199 199 4 213 213 213 4 260 261 4 4 4 4 4 4 4 4 4 4 4 4 4 4 4 4 4 4 4 4 4 4 4 4 4 4 4 4 4 4 4 4 4 4 4 4 4 4 4 4 4 4 4 53 44 1 1 1 1 1 1 1 
1 1 1 1 1 1 1 1 1 1 37 53 254 257 4 4 4 4 17 256 259 349 351 351 353 4 4 4 4 4 4 4 255 258 4 192 4 213 213 199 199 4 4 199 4 4 254 257 4 4 4 4 4 192 192 192 192 192 192 192 192 192 213 213 213 4 4 4 4 4 4 4 4 4 4 4 4 4 4 4 4 4 4 4 4 4 4 4 4 4 4 53 44 1 1 1 1 1 1 1 
1 1 1 1 1 1 1 1 1 1 37 53 255 258 4 4 4 4 4 254 257 366 361 363 369 4 4 4 4 4 4 4 256 259 4 192 4 4 199 199 199 4 4 199 199 199 255 258 199 199 199 4 4 4 4 4 4 192 4 4 254 257 254 257 4 4 4 4 4 4 4 4 4 4 4 4 4 4 4 4 4 4 4 4 4 4 4 4 4 4 4 53 44 1 1 1 1 1 1 1 
1 1 1 1 1 1 1 1 1 1 37 53 256 259 4 4 68 71 4 255 258 367 364 371 370 4 4 4 4 4 4 254 257 4 4 192 4 4 4 4 4 4 4 4 4 4 260 261 254 257 254 257 4 4 4 4 4 4 4 199 255 258 255 258 4 4 4 4 4 4 4 4 4 4 4 4 4 4 4 4 4 4 4 4 4 4 4 4 4 4 4 53 44 1 1 1 1 1 1 1 
1 1 1 1 1 1 1 1 1 1 37 53 254 257 4 4 69 72 4 256 259 4 4 4 4 4 4 4 4 4 4 255 258 4 4 192 192 192 192 192 192 192 192 192 192 192 192 192 255 258 255 258 254 257 254 257 254 257 254 257 260 261 260 261 4 213 4 4 4 4 4 4 4 4 4 4 4 4 4 4 4 4 4 4 4 4 4 4 4 4 213 53 44 1 1 1 1 1 1 1 
1 1 1 1 1 1 1 1 1 1 37 53 255 258 4 4 69 72 254 257 254 257 254 257 4 4 4 4 4 4 4 256 259 4 4 213 17 213 4 348 350 351 353 4 4 4 4 4 256 259 256 259 255 258 255 258 255 258 255 258 254 257 4 4 4 292 282 282 282 282 282 282 282 282 282 282 282 282 282 282 282 282 282 282 282 282 282 282 282 282 295 53 44 1 1 1 1 1 1 1 
1 1 1 1 1 1 1 1 1 1 37 53 256 259 4 4 69 72 255 258 255 258 255 258 254 257 254 257 4 4 254 257 254 257 4 4 4 4 4 365 360 363 369 4 4 4 4 4 4 4 4 4 256 259 256 259 256 259 256 259 255 258 4 4 254 257 4 4 4 4 4 4 4 4 4 4 4 4 4 4 4 4 4 4 4 4 4 4 4 4 4 53 44 1 1 1 1 1 1 1 
1 1 1 1 1 1 1 1 1 1 37 53 254 257 4 4 69 72 256 259 256 259 256 259 255 258 255 258 4 4 255 258 255 258 4 4 4 4 4 367 364 371 370 4 4 4 4 4 4 4 4 4 4 4 4 4 4 4 4 4 256 259 254 257 255 258 4 4 4 4 4 4 4 4 4 4 4 4 4 4 4 4 4 4 4 4 4 4 4 4 4 53 44 1 1 1 1 1 1 1 
1 1 1 1 1 1 1 1 1 1 37 53 255 258 4 4 69 76 67 67 67 67 67 71 256 259 256 259 4 4 256 259 256 259 36 30 30 39 4 4 4 4 4 4 4 4 4 33 42 4 4 4 4 4 4 4 4 4 4 4 254 257 255 258 256 259 4 4 4 4 4 4 4 4 4 4 4 4 4 4 4 4 4 4 4 4 4 4 4 4 4 53 44 1 1 1 1 1 1 1 
1 1 1 1 1 1 1 1 1 1 37 53 256 259 4 4 70 74 74 74 74 74 77 72 254 257 4 4 4 4 4 4 4 4 37 15 306 35 30 30 30 30 30 30 30 30 30 41 44 4 4 4 4 4 4 4 4 4 4 4 255 258 256 259 192 4 4 4 466 469 470 4 4 4 4 4 4 4 4 4 466 469 470 4 4 4 4 4 4 4 4 53 44 1 1 1 1 1 1 1 
1 1 1 1 1 1 1 1 1 1 37 53 36 30 39 4 4 4 33 30 42 4 69 72 255 258 4 4 4 4 4 4 4 4 4 4 37 306 15 15 306 306 306 306 15 306 306 15 44 4 4 4 4 4 4 4 4 4 4 195 256 259 193 4 4 4 4 4 467 9 471 4 4 4 4 4 4 4 4 4 467 9 471 4 4 4 4 4 4 4 4 53 44 1 1 1 1 1 1 1 
1 1 1 1 1 1 1 1 1 1 37 53 37 306 35 30 30 30 41 306 43 4 69 72 256 259 4 4 4 4 4 4 4 4 4 4 4 4 4 4 4 4 4 4 4 4 4 4 4 4 4 4 4 4 254 257 68 67 67 71 4 4 193 4 4 4 4 4 468 473 472 4 4 4 4 4 4 4 4 4 468 473 472 4 4 4 4 4 4 4 4 53 44 1 1 1 1 1 1 1 
1 1 1 1 1 1 1 1 1 1 37 53 202 37 15 306 15 306 15 44 203 4 69 72 348 350 350 352 4 4 4 4 4 4 4 4 4 4 4 4 4 4 4 4 4 4 4 4 4 4 348 351 350 353 255 258 69 3 3 72 254 257 193 4 4 4 4 4 505 505 450 450 450 450 450 450 450 450 450 452 505 505 458 4 4 4 4 4 4 4 4 53 44 1 1 1 1 1 1 1 
1 1 1 1 1 1 1 1 1 1 37 53 206 203 37 15 306 15 44 203 206 4 69 72 354 356 356 358 4 4 4 4 4 4 4 213 213 213 213 213 213 213 213 213 4 4 4 4 68 71 354 357 356 359 256 259 69 3 75 73 255 258 254 257 4 4 4 4 457 505 505 505 505 505 505 505 505 505 505 505 505 505 457 4 4 4 4 4 4 4 4 53 44 1 1 1 1 1 1 1 
1 1 1 1 1 1 1 1 1 1 37 53 203 202 213 213 19 213 213 203 203 4 69 72 365 360 362 368 4 4 4 4 4 4 4 213 213 202 348 350 350 352 254 257 4 4 4 4 69 72 365 361 362 369 254 257 69 3 72 4 256 259 255 258 4 4 4 4 457 460 460 460 460 460 460 460 460 460 460 460 460 460 457 4 4 4 4 4 4 4 4 53 44 1 1 1 1 1 1 1 
1 1 1 1 1 1 1 1 1 1 37 53 202 206 213 213 4 213 213 206 206 4 69 72 367 364 371 370 4 4 4 4 4 4 4 213 213 204 354 356 356 358 255 258 4 4 4 4 69 72 367 364 371 370 255 258 69 3 72 4 254 257 256 259 4 4 4 4 457 506 506 506 506 506 506 506 506 506 506 506 506 506 457 4 4 4 4 4 4 4 4 53 44 1 1 1 1 1 1 1 
1 1 1 1 1 1 1 1 1 1 37 53 4 206 206 203 4 206 203 202 206 4 69 76 67 67 71 4 4 4 4 4 4 4 4 213 213 204 365 360 362 368 256 259 4 4 4 4 69 72 68 67 71 4 256 259 69 3 72 208 255 258 4 4 4 4 4 4 457 506 506 506 506 506 506 506 506 506 506 506 506 506 457 4 4 4 4 4 4 4 4 53 44 1 1 1 1 1 1 1 
1 1 1 1 1 1 1 1 1 1 37 53 4 4 4 4 4 4 4 4 4 4 69 3 3 3 72 4 4 4 4 4 4 4 4 213 213 203 367 364 371 370 213 213 4 4 4 4 69 72 69 3 72 4 254 257 69 3 72 4 256 259 4 4 4 4 4 4 457 506 506 506 506 506 506 506 506 506 506 506 506 506 457 4 4 4 4 4 4 4 4 53 44 1 1 1 1 1 1 1 
1 1 1 1 1 1 1 1 1 1 37 53 4 4 4 4 4 4 4 4 4 4 70 74 74 74 73 4 4 4 4 4 4 4 4 213 213 205 68 67 71 209 213 213 4 4 4 4 69 72 69 3 72 4 255 258 69 3 72 4 254 257 4 4 4 4 4 4 457 506 506 506 506 506 506 506 506 506 506 506 506 506 457 4 4 4 4 4 4 4 4 53 44 1 1 1 1 1 1 1 
1 1 1 1 1 1 1 1 1 1 37 53 4 4 4 4 4 68 67 67 67 67 67 67 67 67 71 4 4 4 4 4 4 4 4 213 213 213 69 3 72 195 213 213 4 4 4 4 69 72 69 3 72 4 256 259 69 3 72 4 255 258 4 4 4 4 4 4 457 506 506 506 506 506 506 506 506 506 506 506 506 506 457 4 4 4 4 4 4 4 4 53 44 1 1 1 1 1 1 1 
1 1 1 1 1 1 1 1 1 1 37 53 4 4 4 4 4 69 75 74 74 74 74 74 74 77 72 4 4 4 4 4 4 4 4 4 4 4 69 3 72 4 4 4 68 67 67 67 78 76 78 3 76 67 67 67 78 3 72 4 256 259 4 4 4 4 4 4 457 506 506 506 506 506 506 506 506 506 506 506 506 506 457 4 4 4 4 4 4 4 4 53 44 1 1 1 1 1 1 1 
1 1 1 1 1 1 1 1 1 1 37 53 4 4 4 4 4 69 72 4 254 257 4 4 4 69 76 67 67 67 67 67 67 67 67 67 67 67 78 3 72 4 4 4 69 3 3 3 3 3 3 3 3 3 3 3 3 3 72 4 254 257 4 4 4 4 4 4 457 506 506 506 506 506 506 506 506 506 506 506 506 506 457 4 4 4 4 4 4 4 4 53 44 1 1 1 1 1 1 1 
1 1 1 1 1 1 1 1 1 1 37 53 4 4 4 4 4 69 72 4 255 258 4 4 4 70 74 74 74 74 74 74 74 74 74 74 74 74 74 74 73 4 4 4 70 74 74 74 74 74 74 74 74 74 74 74 74 74 73 4 255 258 4 4 4 4 4 4 457 506 506 506 506 506 506 506 506 506 506 506 506 506 457 4 4 4 4 4 4 4 4 53 44 1 1 1 1 1 1 1 
1 1 1 1 1 1 1 1 1 1 37 53 4 349 351 351 353 69 72 4 256 259 4 4 4 4 4 4 4 4 4 4 4 4 4 270 276 276 276 276 276 276 276 276 276 276 273 4 4 4 4 4 4 4 4 4 4 4 4 4 256 259 4 4 4 4 4 4 457 506 506 506 506 506 506 506 506 506 506 506 506 506 457 4 4 4 4 4 4 4 4 53 44 1 1 1 1 1 1 1 
1 1 1 1 1 1 1 1 1 1 37 53 4 355 357 357 359 69 72 4 254 257 4 4 4 4 4 4 4 4 4 4 4 4 4 271 2 2 2 2 2 2 2 2 2 2 274 4 285 282 282 282 284 349 351 351 353 4 4 4 254 257 4 4 4 4 4 4 457 506 506 506 506 506 506 506 506 506 506 506 506 506 457 4 4 4 4 4 4 4 4 53 44 1 1 1 1 1 1 1 
1 1 1 1 1 1 1 1 1 1 37 35 39 366 361 363 369 69 72 4 255 258 4 4 4 4 4 4 4 4 4 4 4 4 4 271 2 2 2 2 2 2 2 2 2 2 274 4 286 202 205 209 209 355 357 357 359 4 4 4 255 258 4 4 4 4 4 4 466 469 470 506 506 506 506 506 506 506 506 506 466 469 470 4 4 4 4 4 4 4 4 53 44 1 1 1 1 1 1 1 
1 1 1 1 1 1 1 1 1 1 37 15 53 367 364 371 370 69 72 4 256 259 4 4 4 4 4 4 4 4 4 4 4 4 4 271 2 2 270 276 276 276 276 273 2 2 274 4 286 205 205 209 209 366 361 363 369 4 4 4 256 259 4 4 4 4 4 4 467 9 471 506 506 506 506 506 506 506 506 506 467 9 471 4 4 4 4 4 4 4 4 53 44 1 1 1 1 1 1 1 
1 1 1 1 1 1 1 1 1 1 1 37 53 4 4 4 4 69 72 4 254 257 193 193 193 193 193 193 193 193 4 4 4 4 4 271 2 2 271 2 2 2 2 274 2 2 274 4 286 209 209 209 209 367 364 371 370 4 4 4 254 257 4 4 4 4 4 4 468 473 472 506 506 506 506 506 506 506 506 506 468 473 472 4 4 4 4 4 4 4 4 53 44 1 1 1 1 1 1 1 
1 1 1 1 1 1 1 1 1 1 1 37 53 4 4 4 4 69 72 4 255 258 193 4 348 350 350 352 4 193 4 4 4 4 4 271 2 2 272 277 277 277 277 275 2 2 274 4 287 282 295 4 4 4 4 4 4 4 4 4 255 258 4 4 4 4 4 4 505 505 505 450 451 451 506 506 506 451 451 452 505 505 505 4 4 4 4 4 4 4 4 53 44 1 1 1 1 1 1 1 
1 1 1 1 1 1 1 1 1 1 1 37 53 4 68 67 67 78 72 209 256 259 4 4 354 356 356 358 4 4 4 4 4 4 4 271 2 2 2 2 2 2 2 2 2 2 274 4 4 4 4 4 4 4 4 4 4 4 4 4 256 259 4 4 4 4 4 4 505 505 505 505 505 505 506 506 506 505 505 505 505 505 505 4 4 4 4 4 4 4 4 53 44 1 1 1 1 1 1 1 
1 1 1 1 1 1 1 1 1 1 1 37 53 4 69 75 74 74 73 254 257 254 257 4 365 360 362 368 4 4 4 4 4 4 4 271 2 2 2 2 2 2 2 2 2 2 274 4 4 4 4 4 4 4 4 4 4 4 4 4 254 257 4 4 4 4 4 4 460 460 460 460 460 460 506 506 506 460 460 460 460 460 460 4 4 4 4 4 4 4 4 53 44 1 1 1 1 1 1 1 
1 1 1 1 1 1 1 1 1 1 1 37 53 4 69 72 4 4 4 255 258 255 258 4 367 364 371 370 4 4 4 4 4 4 4 272 277 277 277 277 277 277 277 277 277 277 275 4 4 4 4 4 4 4 4 4 4 4 4 4 255 258 4 4 4 4 4 4 4 4 4 4 4 444 441 441 441 447 4 4 4 4 4 4 4 4 4 4 4 4 4 53 44 1 1 1 1 1 1 1 
1 1 1 1 1 1 1 1 1 1 1 37 53 4 69 72 4 4 4 256 259 256 259 4 4 4 4 4 4 4 4 4 4 4 4 4 4 4 4 4 4 4 4 4 4 4 4 4 4 4 4 4 4 4 4 4 195 4 4 4 256 259 4 4 4 4 4 4 4 4 4 4 4 444 441 441 441 447 4 4 4 4 4 4 4 4 4 4 4 4 4 53 44 1 1 1 1 1 1 1 
1 1 1 1 1 1 1 1 1 1 1 37 53 4 69 72 254 257 254 257 254 257 254 257 254 257 254 257 254 257 254 257 254 257 254 257 254 257 254 257 254 257 254 257 254 257 254 257 254 257 4 4 4 4 4 4 4 4 24 22 22 27 4 4 4 4 4 4 4 4 4 4 4 444 441 441 441 447 4 4 4 4 4 4 4 4 4 4 4 4 4 53 44 1 1 1 1 1 1 1 
1 1 1 1 1 1 1 1 1 1 1 37 53 4 69 72 255 258 255 258 255 258 255 258 255 258 255 258 255 258 255 258 255 258 255 258 255 258 255 258 255 258 255 258 255 258 255 258 255 258 254 257 4 4 4 4 4 4 25 1 1 28 4 4 4 4 4 4 4 4 4 4 4 444 441 441 441 447 4 4 4 4 4 4 4 4 4 4 4 4 4 53 44 1 1 1 1 1 1 1 
1 1 1 1 1 1 1 1 1 1 1 37 53 68 78 72 256 259 256 259 256 259 256 259 256 259 256 259 256 259 256 259 260 261 256 259 256 259 256 259 256 259 256 259 256 259 256 259 256 259 255 258 254 257 4 4 4 4 25 1 1 28 4 4 4 4 4 4 4 4 4 4 4 444 441 441 441 447 4 4 4 4 4 4 4 4 4 4 4 4 4 53 44 1 1 1 1 1 1 1 
1 1 1 1 1 1 1 1 1 1 1 37 53 69 3 76 67 67 67 67 67 67 67 67 67 67 67 67 67 67 67 67 67 67 67 67 67 67 67 67 71 4 4 4 4 4 4 4 4 4 256 259 255 258 4 4 4 4 25 1 1 28 4 4 4 4 4 4 4 4 4 4 4 444 441 441 441 447 4 4 4 4 4 4 4 4 4 4 4 4 4 53 44 1 1 1 1 1 1 1 
1 1 1 1 1 1 1 1 1 1 1 37 53 69 3 3 3 3 75 74 74 74 74 74 77 75 74 74 77 3 3 3 3 3 3 3 75 74 74 74 73 4 4 4 4 4 4 4 4 4 4 4 256 259 254 257 4 4 25 1 1 28 4 4 4 4 4 4 4 4 4 4 4 444 441 441 441 447 4 4 4 4 4 4 4 4 4 4 4 4 4 53 44 1 1 1 1 1 1 1 
1 1 1 1 1 1 1 1 1 1 1 38 53 69 3 3 3 3 72 33 30 30 30 42 69 72 66 66 69 75 74 74 74 74 74 74 73 68 67 71 4 4 68 67 67 71 4 4 4 4 4 4 4 4 255 258 4 4 26 23 23 29 254 257 4 4 4 4 4 4 4 4 4 444 441 441 441 447 4 4 4 4 4 4 4 4 4 4 4 4 4 53 44 1 1 1 1 1 1 1 
1 1 1 1 1 1 1 1 1 1 1 37 53 69 3 3 3 3 72 53 306 15 306 306 70 73 4 4 69 72 4 4 4 4 4 4 4 70 74 73 4 4 70 74 74 73 4 4 4 4 4 4 4 209 260 261 254 257 254 257 254 257 255 258 4 4 4 4 4 4 4 4 4 444 441 441 441 447 4 4 4 4 4 4 4 4 4 4 4 4 4 53 44 1 1 1 1 1 1 1 
1 1 1 1 1 1 1 1 1 1 38 3 53 70 74 74 74 74 73 53 4 4 4 4 4 4 4 4 69 72 4 254 257 4 4 68 67 71 254 257 254 257 254 257 254 257 4 4 4 4 4 4 4 254 257 4 255 258 255 258 255 258 256 259 4 4 4 4 4 4 4 4 4 444 441 441 441 447 4 4 4 4 4 4 4 4 4 4 4 4 4 53 44 1 1 1 1 1 1 1 
1 1 1 1 1 1 1 1 1 1 37 33 41 36 39 4 4 4 4 53 4 4 4 66 66 21 4 4 69 72 4 255 258 254 257 70 74 73 255 258 255 258 255 258 255 258 4 4 4 4 4 4 4 255 258 4 256 259 256 259 256 259 4 4 4 4 4 4 4 4 4 4 4 444 441 441 441 447 4 4 4 4 4 4 4 4 4 4 4 4 4 53 44 1 1 1 1 1 1 1 
1 1 1 1 1 1 1 1 1 1 37 53 15 306 35 30 30 30 30 41 4 4 4 4 4 4 33 42 69 72 4 256 259 255 258 21 4 4 256 259 260 261 256 259 260 261 4 4 66 210 4 4 66 256 259 4 4 4 4 4 4 4 4 4 4 4 4 4 4 4 4 4 4 444 441 441 441 447 4 4 4 4 4 4 4 4 4 4 4 4 4 53 44 1 1 1 1 1 1 1 
1 1 1 1 1 1 1 1 1 1 37 53 4 3 306 306 306 15 306 44 4 4 4 4 4 4 53 68 78 72 4 254 257 260 261 21 21 21 21 4 4 4 4 4 4 4 4 4 4 4 4 4 4 254 257 4 4 4 4 4 4 4 4 4 4 4 4 4 4 4 4 4 4 4 4 4 4 4 4 4 4 4 4 4 4 4 4 4 4 4 4 53 44 1 1 1 1 1 1 1 
1 1 1 1 1 1 1 1 1 1 37 53 4 4 4 68 67 71 4 4 4 4 4 4 4 4 53 69 3 72 199 255 258 4 4 68 67 67 71 4 4 4 254 257 4 4 4 4 4 4 4 66 4 255 258 4 4 4 4 4 4 4 4 4 4 4 4 4 4 4 4 4 4 4 4 4 4 4 4 4 4 4 4 4 4 4 4 4 4 4 4 53 44 1 1 1 1 1 1 1 
1 1 1 1 1 1 1 1 1 1 37 53 4 4 4 69 3 76 67 67 71 4 4 4 4 4 53 69 3 72 4 256 259 4 4 69 3 3 72 4 4 4 255 258 4 4 4 4 4 4 4 4 4 260 261 4 4 4 4 4 4 4 4 4 4 4 4 4 4 4 4 4 4 4 4 4 4 4 4 4 4 4 4 4 4 4 4 4 4 4 4 53 44 1 1 1 1 1 1 1 
1 1 1 1 1 1 1 1 1 1 37 53 4 4 4 69 3 3 3 3 72 4 4 4 4 4 53 69 3 72 4 254 257 4 4 69 3 3 72 4 4 4 256 259 4 4 4 4 211 4 4 4 4 254 257 4 4 4 4 4 4 4 4 4 4 4 4 4 4 4 4 4 4 4 4 4 4 4 4 4 4 4 4 4 4 4 4 4 4 4 4 53 44 1 1 1 1 1 1 1 
1 1 1 1 1 1 1 1 1 1 37 53 4 66 4 70 74 74 77 3 72 4 4 4 4 4 53 69 3 72 4 255 258 4 4 69 3 3 72 4 4 4 4 254 257 254 257 4 4 4 4 4 4 255 258 4 4 4 4 4 4 4 4 4 4 4 4 4 4 4 4 4 4 4 4 4 4 4 4 4 4 4 4 4 4 4 4 4 4 4 4 53 44 1 1 1 1 1 1 1 
1 1 1 1 1 1 1 1 1 1 37 53 4 4 4 4 4 4 69 3 72 4 4 33 30 30 41 69 3 72 4 256 259 4 4 69 75 74 73 4 4 4 4 255 258 255 258 4 4 4 4 4 4 256 259 4 4 4 4 4 4 4 4 4 4 4 4 4 4 4 4 4 4 4 4 4 4 4 4 4 4 4 4 4 4 4 4 4 4 4 4 53 44 1 1 1 1 1 1 1 
1 1 1 1 1 1 1 1 1 1 37 34 30 30 30 30 30 30 42 474 36 30 30 41 306 306 44 69 3 72 4 254 257 4 4 70 73 4 4 4 4 4 4 256 259 260 261 283 282 282 282 282 282 282 288 254 257 4 4 4 4 4 4 4 4 4 4 4 4 4 4 4 4 4 4 4 4 4 4 4 4 4 4 4 4 4 4 4 4 4 4 53 44 1 1 1 1 1 1 1 
1 1 1 1 1 1 1 1 1 1 37 53 306 16 306 306 15 306 44 474 37 15 306 15 3 4 4 70 74 73 4 255 258 4 4 4 4 4 4 4 4 4 4 254 257 195 17 4 4 195 437 195 4 4 289 255 258 4 4 4 4 4 4 4 4 4 4 4 4 4 4 4 4 4 4 4 4 4 4 4 4 4 4 4 4 4 4 4 4 4 4 53 44 1 1 1 1 1 1 1 
1 1 1 1 1 1 1 1 1 1 37 53 207 206 203 200 200 200 209 4 4 4 4 4 4 4 199 4 4 4 4 256 259 4 4 4 4 4 4 4 4 4 4 255 258 4 4 4 4 68 67 71 4 4 289 256 259 4 4 4 4 4 4 4 4 4 4 4 4 4 4 4 4 4 4 4 4 4 4 4 4 4 4 4 4 4 4 4 4 4 4 53 44 1 1 1 1 1 1 1 
1 1 1 1 1 1 1 1 1 1 37 53 200 200 200 211 200 200 200 200 4 4 4 4 4 4 4 4 66 66 66 254 257 4 4 68 67 67 71 4 4 4 4 256 259 68 67 67 67 78 3 72 4 283 290 4 4 4 4 4 4 4 4 4 4 4 4 4 4 4 4 4 4 4 4 4 4 4 4 4 4 4 4 4 4 4 4 4 4 4 4 53 44 1 1 1 1 1 1 1 
1 1 1 1 1 1 1 1 1 1 37 53 211 200 36 30 39 4 4 4 4 4 4 4 4 209 4 4 4 4 4 255 258 4 4 69 3 3 72 4 4 4 4 202 200 69 3 3 3 3 3 72 4 254 257 211 4 4 4 4 4 4 4 4 4 4 4 4 4 4 4 4 4 4 4 4 4 4 4 4 4 4 4 4 4 4 4 4 4 4 4 53 44 1 1 1 1 1 1 1 
1 1 1 1 1 1 1 1 1 1 37 53 4 195 37 306 53 4 4 4 4 211 66 66 4 4 4 4 4 199 4 256 259 4 4 70 74 74 73 4 4 4 4 4 200 70 77 3 3 3 3 72 4 255 258 209 4 4 4 4 4 4 4 4 4 4 4 4 4 254 257 4 4 4 4 4 4 4 4 4 4 4 4 4 4 4 4 4 4 4 4 53 44 1 1 1 1 1 1 1 
1 1 1 1 1 1 1 1 1 1 37 53 398 9 9 9 35 30 30 30 30 30 30 30 30 30 30 30 30 30 30 30 30 30 30 30 30 30 30 30 30 30 30 30 30 39 70 74 74 74 74 73 4 256 259 202 4 4 4 4 4 4 4 4 4 254 257 254 257 255 258 254 257 254 257 254 257 254 257 254 257 254 257 254 257 4 4 4 4 4 4 53 44 1 1 1 1 1 1 1 
1 1 1 1 1 1 1 1 1 1 37 53 9 9 9 9 37 306 306 15 306 306 306 306 15 306 306 306 306 306 306 16 306 306 306 306 306 306 15 306 306 15 306 306 16 35 30 30 30 30 30 30 30 30 30 30 30 30 30 30 30 30 30 30 39 255 258 255 258 256 259 255 258 255 258 255 258 255 258 255 258 255 258 255 258 4 4 4 4 4 4 53 44 1 1 1 1 1 1 1 
1 1 1 1 1 1 1 1 1 1 37 53 9 9 9 9 9 9 9 9 9 9 9 9 9 19 9 9 9 9 244 243 246 9 495 350 350 496 9 244 243 246 244 243 246 244 243 246 244 243 246 9 9 9 9 9 9 9 9 9 9 9 9 9 53 256 259 256 259 33 42 256 259 256 259 256 259 256 259 256 259 256 259 256 259 4 4 4 4 4 4 53 44 1 1 1 1 1 1 1 
1 1 1 1 1 1 1 1 1 1 37 53 9 9 9 244 243 246 9 244 243 246 9 9 9 9 9 9 9 9 245 239 247 9 497 356 356 498 234 245 239 247 245 239 247 245 239 247 245 239 247 9 9 9 228 9 9 9 9 9 234 9 9 9 35 30 30 31 30 41 4 4 4 4 4 4 4 4 4 4 4 202 4 4 4 4 4 4 4 4 4 53 44 1 1 1 1 1 1 1 
1 1 1 1 1 1 1 1 1 1 37 53 9 9 9 245 239 247 9 245 239 247 9 9 9 221 9 9 9 9 9 248 9 9 499 360 362 501 9 9 248 9 227 248 9 9 248 9 9 248 9 9 9 9 9 9 9 9 9 9 9 9 9 9 4 4 4 53 4 4 4 4 4 4 4 4 4 4 4 4 4 4 4 4 4 4 4 4 4 4 4 53 44 1 1 1 1 1 1 1 
1 1 1 1 1 1 1 1 1 1 37 53 9 9 9 9 248 9 9 9 248 225 9 9 9 9 9 9 9 233 9 9 9 9 500 364 371 502 9 9 9 9 400 9 9 9 9 9 9 9 9 9 9 9 9 9 9 9 9 9 9 9 9 9 4 4 4 48 4 4 4 4 4 4 4 4 4 4 4 4 4 4 4 4 4 4 4 4 4 4 4 53 44 1 1 1 1 1 1 1 
1 1 1 1 1 1 1 1 1 1 37 53 9 9 9 9 9 9 9 9 9 9 9 9 9 33 30 42 9 9 36 30 30 39 9 9 9 9 9 221 9 9 9 9 9 9 9 9 9 9 227 9 9 9 234 9 9 9 231 9 9 9 9 4 4 4 4 4 4 4 4 4 4 4 4 4 4 4 4 4 4 4 4 4 4 4 4 4 4 4 4 53 44 1 1 1 1 1 1 1 
1 1 1 1 1 1 1 1 1 1 37 53 9 9 9 227 9 9 9 9 9 9 9 9 9 53 306 44 9 9 37 15 306 53 9 9 9 9 9 9 9 9 33 30 30 42 9 9 9 9 9 9 9 9 9 9 9 9 9 9 9 36 39 4 4 4 4 52 4 4 4 4 4 4 4 4 4 4 4 4 4 4 4 4 4 4 4 4 4 4 4 53 44 1 1 1 1 1 1 1 
1 1 1 1 1 1 1 1 1 1 37 53 9 9 9 9 9 9 9 9 9 9 9 9 9 53 44 9 9 9 9 9 9 35 42 9 9 36 30 30 30 30 41 306 15 44 9 9 9 9 9 37 33 30 39 9 9 9 9 9 9 9 53 4 4 4 4 53 4 4 4 4 4 4 4 4 4 4 4 4 4 4 4 4 4 4 4 4 4 4 4 53 44 1 1 1 1 1 1 1 
1 1 1 1 1 1 1 1 1 1 37 53 9 401 33 30 30 42 474 474 36 30 30 30 30 41 44 9 9 231 9 9 9 306 43 398 9 37 306 306 306 306 306 306 9 9 9 9 9 9 9 37 53 3 35 30 30 30 39 9 9 9 35 30 30 39 52 35 42 4 4 4 4 4 4 4 4 4 4 4 4 4 4 4 4 4 4 4 4 4 4 53 44 1 1 1 1 1 1 1 
1 1 1 1 1 1 1 1 1 1 37 53 9 9 53 3 306 43 474 474 37 306 16 306 306 15 44 9 9 9 9 9 9 9 9 9 9 9 9 9 9 9 9 9 9 9 9 9 9 9 9 37 53 3 3 3 33 30 41 9 9 9 9 9 9 53 53 53 4 4 4 4 4 4 4 4 4 4 4 4 4 4 4 4 4 4 4 4 4 4 4 53 44 1 1 1 1 1 1 1 
1 1 1 1 1 1 1 1 1 1 37 53 9 9 53 44 9 9 9 9 9 9 9 9 9 9 9 9 221 9 9 9 9 9 9 9 234 244 243 246 9 227 223 9 9 9 9 9 9 9 9 37 53 3 3 3 53 306 306 9 9 9 244 243 246 53 53 53 4 4 4 4 4 4 4 4 4 4 4 4 4 4 4 4 4 4 4 4 4 4 4 53 44 1 1 1 1 1 1 1 
1 1 1 1 1 1 1 1 1 1 37 53 9 503 53 44 9 9 9 9 9 9 9 9 9 9 9 9 9 9 9 9 9 234 9 9 9 245 239 247 9 9 9 221 9 9 9 9 9 9 9 37 53 33 30 30 41 44 228 9 9 9 245 239 247 53 53 53 4 4 4 4 4 4 4 4 4 4 4 4 4 4 4 4 4 4 4 4 4 4 4 53 44 1 1 1 1 1 1 1 
1 1 1 1 1 1 1 1 1 1 37 35 30 30 41 44 9 9 9 9 9 9 9 9 9 9 9 221 9 9 9 9 9 9 9 9 9 9 248 233 9 9 9 9 9 9 9 9 9 9 9 38 53 53 16 306 306 44 9 234 9 9 9 248 9 53 53 53 4 4 4 4 4 4 4 4 4 4 4 4 4 4 4 4 4 4 4 4 4 4 4 53 44 1 1 1 1 1 1 1 
1 1 1 1 1 1 1 1 1 1 37 15 16 306 15 44 212 212 212 212 212 212 212 212 212 212 212 212 212 212 212 212 212 212 212 212 212 212 212 212 212 212 212 212 212 212 212 212 212 212 212 37 53 53 44 212 212 212 212 212 212 212 212 212 212 53 48 53 4 4 4 4 4 4 4 4 4 4 4 4 4 4 4 4 4 4 4 4 4 4 4 53 44 1 1 1 1 1 1 1 
1 1 1 1 1 1 1 1 1 1 318 312 312 312 312 334 198 198 198 198 198 198 198 198 198 198 198 198 198 198 198 198 198 198 198 198 198 198 198 198 198 198 198 198 198 198 198 198 198 198 198 37 53 53 44 198 198 198 198 198 198 198 198 198 198 35 30 32 30 30 30 30 30 30 30 30 30 30 30 30 30 30 30 30 30 30 30 30 30 30 30 41 44 1 1 1 1 1 1 1 
1 1 1 1 1 1 1 1 1 1 2 2 2 2 2 2 2 2 2 2 2 2 2 2 2 2 2 2 2 2 2 2 2 2 2 2 2 2 2 2 2 2 2 2 2 2 2 2 2 2 2 37 53 53 44 2 2 2 2 2 2 2 2 2 2 37 15 306 16 306 306 306 306 15 306 306 306 306 15 306 306 306 306 16 306 306 306 15 306 306 306 16 44 1 1 1 1 1 1 1 
1 1 1 1 1 1 1 1 1 1 2 2 2 2 2 2 2 2 2 2 2 2 2 2 2 2 2 2 2 2 2 2 2 2 2 2 2 2 2 2 2 2 2 2 2 2 2 2 215 2 2 37 35 41 44 2 2 214 2 2 217 2 2 215 2 37 15 44 1 1 1 1 1 1 1 1 1 1 1 1 1 1 1 1 1 1 1 1 1 1 1 1 1 1 1 1 1 1 1 1 
1 1 1 1 1 1 1 1 1 1 2 2 220 2 2 2 2 214 2 2 2 2 217 2 214 2 2 2 2 217 2 2 2 218 2 2 2 2 2 219 2 2 2 2 214 2 2 2 2 2 2 318 312 312 334 2 2 2 2 216 2 2 2 2 2 37 15 44 1 1 1 1 1 1 1 1 1 1 1 1 1 1 1 1 1 1 1 1 1 1 1 1 1 1 1 1 1 1 1 1 
1 1 1 1 1 1 1 1 1 1 1 2 2 2 2 2 2 2 214 2 2 2 214 2 216 2 2 2 2 2 214 2 2 2 2 2 215 2 2 219 2 2 2 2 2 2 2 2 220 220 2 2 2 2 2 2 2 218 2 2 2 219 2 2 2 37 16 44 1 1 1 1 1 1 1 1 1 1 1 1 1 1 1 1 1 1 1 1 1 1 1 1 1 1 1 1 1 1 1 1 
1 1 1 1 1 1 1 1 1 1 1 1 2 2 2 2 2 2 2 2 2 2 2 2 2 2 2 2 2 2 2 2 2 2 2 2 2 2 2 2 2 2 214 2 2 2 2 2 2 2 2 2 2 216 2 2 2 2 2 2 2 2 2 2 2 338 312 324 1 1 1 1 1 1 1 1 1 1 1 1 1 1 1 1 1 1 1 1 1 1 1 1 1 1 1 1 1 1 1 1 
