675 675 675 675 675 675 675 675 675 675 675 675 675 675 675 675 675 675 675 675 675 675 675 675 771 801 797 772 675 675 675 675 675 675 675 675 675 675 675 675 675 675 675 675 675 675 675 675 675 675 
675 675 675 675 675 675 675 675 675 675 675 675 675 675 675 675 675 675 675 675 675 675 675 675 771 805 806 772 675 675 675 675 675 675 675 675 675 675 675 675 675 675 675 675 675 675 675 675 675 675 
675 675 675 675 675 675 675 675 675 675 675 675 675 675 675 675 675 675 675 675 675 675 675 675 771 778 778 772 675 675 675 675 675 675 675 675 675 675 675 675 675 675 675 675 675 675 675 675 675 675 
675 675 675 675 675 675 675 675 675 675 675 675 675 675 675 675 675 675 675 675 675 675 675 675 771 778 778 772 675 675 675 675 675 675 675 675 675 675 675 675 675 675 675 675 675 675 675 675 675 675 
675 675 675 675 675 675 675 675 675 675 675 675 675 675 675 675 675 675 675 675 675 675 675 675 771 778 778 772 675 675 675 675 675 675 675 675 675 675 675 675 675 675 675 675 675 675 675 675 675 675 
675 675 675 675 675 675 675 675 675 675 675 675 675 675 675 675 675 675 675 675 675 675 675 675 771 778 778 772 675 675 675 675 675 675 675 675 675 675 675 675 675 675 675 675 675 675 675 675 675 675 
675 675 675 675 675 675 675 675 675 675 675 675 675 675 675 675 675 675 675 675 675 675 675 675 771 778 778 772 675 675 675 675 675 675 675 675 675 675 675 675 675 675 675 675 675 675 675 675 675 675 
675 675 675 675 675 675 675 675 675 675 675 675 675 675 675 675 675 675 675 675 675 675 675 675 771 778 778 772 675 675 675 675 675 675 675 675 675 675 675 675 675 675 675 675 675 675 675 675 675 675 
675 675 675 675 675 675 675 675 675 675 675 675 675 675 675 675 675 675 675 675 675 675 675 675 771 778 778 772 675 675 675 675 675 675 675 675 675 675 675 675 675 675 675 675 675 675 675 675 675 675 
675 675 675 675 675 675 675 675 765 765 765 765 765 765 765 765 765 765 765 765 765 765 765 765 765 778 778 765 765 765 765 765 765 765 765 765 765 765 765 765 765 765 675 675 675 675 675 675 675 675 
675 675 675 675 675 675 675 675 765 765 765 765 765 765 765 765 765 765 765 765 765 765 765 778 778 778 778 778 765 765 765 765 765 765 765 765 765 765 765 765 765 765 675 675 675 675 675 675 675 675 
675 675 675 675 675 675 675 675 765 765 765 765 765 765 765 765 765 765 765 765 765 778 778 778 778 778 778 778 778 778 765 765 765 765 765 765 765 765 765 765 765 765 675 675 675 675 675 675 675 675 
675 675 675 675 675 675 675 675 765 765 765 765 765 765 765 765 765 765 765 765 778 778 796 796 796 796 796 796 796 796 778 785 765 765 765 765 765 765 765 765 765 765 675 675 675 675 675 675 675 675 
675 675 675 675 675 675 675 675 765 765 765 765 765 765 765 765 765 785 785 778 778 796 796 796 796 796 796 796 796 796 796 792 765 765 765 765 765 765 765 765 765 765 675 675 675 675 675 675 675 675 
675 675 675 675 675 675 675 675 765 765 765 765 765 765 765 765 765 792 792 778 796 796 796 796 796 796 796 796 796 796 796 796 778 765 765 765 765 765 765 765 765 765 675 675 675 675 675 675 675 675 
675 675 675 675 675 675 675 675 765 765 765 765 765 765 765 765 778 778 778 796 796 796 796 796 796 796 796 796 796 796 796 796 778 778 765 765 765 765 765 765 765 765 675 675 675 675 675 675 675 675 
675 675 675 675 675 675 675 675 765 765 765 765 765 765 765 778 778 796 796 796 796 796 796 796 796 796 796 796 796 796 796 796 796 778 778 765 765 765 765 765 765 765 675 675 675 675 675 675 675 675 
675 675 675 675 675 675 675 675 765 765 765 765 765 765 778 778 796 796 796 796 796 796 796 796 796 796 796 796 796 796 796 796 796 796 778 778 765 765 765 765 765 765 675 675 675 675 675 675 675 675 
675 675 675 675 675 675 675 675 765 765 765 765 765 778 778 796 796 796 796 796 796 796 796 796 796 796 796 796 796 796 796 796 796 796 796 778 778 765 765 765 765 765 675 675 675 675 675 675 675 675 
675 675 675 675 675 675 675 675 765 765 765 785 778 778 796 796 796 796 796 796 796 796 796 796 796 796 796 796 796 796 796 796 796 796 796 796 778 778 765 765 765 765 675 675 675 675 675 675 675 675 
675 675 675 675 675 675 675 675 765 765 765 792 778 796 796 796 796 796 796 796 796 796 796 796 796 796 796 796 796 796 796 796 796 796 796 796 796 778 785 765 765 765 675 675 675 675 675 675 675 675 
675 675 675 675 675 675 675 675 765 765 785 778 796 796 796 796 796 796 796 796 796 796 796 796 796 796 796 796 796 796 796 796 796 796 796 796 796 796 792 785 765 765 675 675 675 675 675 675 675 675 
675 675 675 675 675 675 675 675 765 765 792 796 796 796 796 796 796 796 796 796 796 796 796 796 796 796 796 796 796 796 796 796 796 796 796 796 796 796 796 792 765 765 675 675 675 675 675 675 675 675 
675 675 675 675 675 675 675 675 765 765 778 796 796 796 796 796 796 796 796 796 796 796 796 796 796 796 796 796 796 796 796 796 796 796 796 796 796 796 796 778 765 765 675 675 675 675 675 675 675 675 
675 675 675 675 675 675 675 675 765 765 778 796 796 796 796 796 796 796 796 796 796 796 796 796 796 796 796 796 796 796 796 796 796 796 796 796 796 796 796 778 765 765 675 675 675 675 675 675 675 675 
675 675 675 675 675 675 675 675 765 788 778 796 796 796 796 796 796 796 796 796 796 796 796 796 796 796 796 796 796 796 796 796 796 796 796 796 796 796 796 778 788 765 675 675 675 675 675 675 675 675 
675 675 675 675 675 675 675 675 765 788 778 796 796 796 796 796 796 796 796 796 796 796 796 796 796 796 796 796 796 796 796 796 796 796 796 796 796 796 796 778 788 765 675 675 675 675 675 675 675 675 
675 675 675 675 675 675 675 675 765 788 778 796 796 796 796 796 796 796 796 796 796 796 796 796 796 796 796 796 796 796 796 796 796 796 796 796 796 796 796 778 788 765 675 675 675 675 675 675 675 675 
675 675 675 675 675 675 675 675 765 765 778 796 796 796 796 796 796 796 796 796 796 796 796 796 796 796 796 796 796 796 796 796 796 796 796 796 796 796 796 778 765 765 675 675 675 675 675 675 675 675 
675 675 675 675 675 675 675 675 765 765 778 796 796 796 796 796 796 796 796 796 796 796 796 796 796 796 796 796 796 796 796 796 796 796 796 796 796 796 796 778 765 765 675 675 675 675 675 675 675 675 
675 675 675 675 675 675 675 675 765 765 778 796 796 796 796 796 796 796 796 796 796 796 796 796 796 796 796 796 796 796 796 796 796 796 796 796 796 796 796 778 765 765 675 675 675 675 675 675 675 675 
675 675 675 675 675 675 675 675 765 765 778 796 796 796 796 796 796 796 796 796 796 796 796 796 796 796 796 796 796 796 796 796 796 796 796 796 796 796 796 778 765 765 675 675 675 675 675 675 675 675 
675 675 675 675 675 675 675 675 765 765 762 778 796 796 796 796 796 796 796 796 796 796 796 796 796 796 796 796 796 796 796 796 796 796 796 796 796 796 778 778 765 765 675 675 675 675 675 675 675 675 
675 675 675 675 675 675 675 675 765 765 762 778 778 796 796 796 796 796 796 796 796 796 796 796 796 796 796 796 796 796 796 796 796 796 796 796 796 778 778 762 765 765 675 675 675 675 675 675 675 675 
675 675 675 675 675 675 675 675 765 765 765 762 778 778 796 796 796 796 796 796 796 796 796 796 796 796 796 796 796 796 796 796 796 796 796 796 778 778 762 765 765 765 675 675 675 675 675 675 675 675 
675 675 675 675 675 675 675 675 765 765 765 765 762 778 778 796 796 796 796 796 796 796 796 796 796 796 796 796 796 796 796 796 796 796 796 778 778 762 765 765 765 765 675 675 675 675 675 675 675 675 
675 675 675 675 675 675 675 675 765 765 765 765 765 762 778 778 796 796 796 796 796 796 796 796 796 796 796 796 796 796 796 796 796 796 778 778 762 765 765 765 765 765 675 675 675 675 675 675 675 675 
675 675 675 675 675 675 675 675 765 765 765 765 765 765 762 778 778 796 796 796 796 796 796 796 796 796 796 796 796 796 796 796 796 778 778 762 765 765 765 765 765 765 675 675 675 675 675 675 675 675 
675 675 675 675 675 675 675 675 765 765 765 765 765 765 765 762 778 778 778 778 778 778 778 778 778 778 778 778 778 778 778 778 778 778 762 765 765 765 765 765 765 765 675 675 675 675 675 675 675 675 
675 675 675 675 675 675 675 675 765 765 765 765 765 765 765 765 765 765 765 765 765 765 765 765 765 765 765 765 765 765 765 765 765 765 765 765 765 765 765 765 765 765 675 675 675 675 675 675 675 675 
675 675 675 675 675 675 675 675 675 675 675 675 675 675 675 675 675 675 675 675 675 675 675 675 675 675 675 675 675 675 675 675 675 675 675 675 675 675 675 675 675 675 675 675 675 675 675 675 675 675 
675 675 675 675 675 675 675 675 675 675 675 675 675 675 675 675 675 675 675 675 675 675 675 675 675 675 675 675 675 675 675 675 675 675 675 675 675 675 675 675 675 675 675 675 675 675 675 675 675 675 
675 675 675 675 675 675 675 675 675 675 675 675 675 675 675 675 675 675 675 675 675 675 675 675 675 675 675 675 675 675 675 675 675 675 675 675 675 675 675 675 675 675 675 675 675 675 675 675 675 675 
675 675 675 675 675 675 675 675 675 675 675 675 675 675 675 675 675 675 675 675 675 675 675 675 675 675 675 675 675 675 675 675 675 675 675 675 675 675 675 675 675 675 675 675 675 675 675 675 675 675 
675 675 675 675 675 675 675 675 675 675 675 675 675 675 675 675 675 675 675 675 675 675 675 675 675 675 675 675 675 675 675 675 675 675 675 675 675 675 675 675 675 675 675 675 675 675 675 675 675 675 
675 675 675 675 675 675 675 675 675 675 675 675 675 675 675 675 675 675 675 675 675 675 675 675 675 675 675 675 675 675 675 675 675 675 675 675 675 675 675 675 675 675 675 675 675 675 675 675 675 675 
675 675 675 675 675 675 675 675 675 675 675 675 675 675 675 675 675 675 675 675 675 675 675 675 675 675 675 675 675 675 675 675 675 675 675 675 675 675 675 675 675 675 675 675 675 675 675 675 675 675 
675 675 675 675 675 675 675 675 675 675 675 675 675 675 675 675 675 675 675 675 675 675 675 675 675 675 675 675 675 675 675 675 675 675 675 675 675 675 675 675 675 675 675 675 675 675 675 675 675 675 
675 675 675 675 675 675 675 675 675 675 675 675 675 675 675 675 675 675 675 675 675 675 675 675 675 675 675 675 675 675 675 675 675 675 675 675 675 675 675 675 675 675 675 675 675 675 675 675 675 675 
675 675 675 675 675 675 675 675 675 675 675 675 675 675 675 675 675 675 675 675 675 675 675 675 675 675 675 675 675 675 675 675 675 675 675 675 675 675 675 675 675 675 675 675 675 675 675 675 675 675 
