675 675 675 675 675 675 675 675 675 675 675 675 675 675 675 675 675 675 675 675 675 675 675 675 675 675 675 675 675 675 675 675 675 675 675 675 675 675 675 675 675 675 675 675 675 675 675 675 675 675 
675 675 675 675 675 675 675 675 675 675 675 675 675 675 675 675 675 675 675 675 675 675 675 675 675 675 675 675 675 675 675 675 675 675 675 675 675 675 675 675 675 675 675 675 675 675 675 675 675 675 
675 675 675 675 675 675 675 675 675 675 675 675 675 675 675 675 675 675 675 675 675 675 675 675 675 675 675 675 675 675 675 675 675 675 675 675 675 675 675 675 675 675 675 675 675 675 675 675 675 675 
675 675 675 675 675 675 675 675 675 675 675 675 675 675 675 675 675 675 675 675 675 675 675 675 675 675 675 675 675 675 675 675 675 675 675 675 675 675 675 675 675 675 675 675 675 675 675 675 675 675 
675 675 675 675 675 675 675 675 675 675 675 675 675 675 675 675 675 675 675 675 675 675 675 675 675 675 675 675 675 675 675 675 675 675 675 675 675 675 675 675 675 675 675 675 675 675 675 675 675 675 
675 675 675 675 675 675 675 675 675 675 675 675 675 675 675 675 675 675 675 675 675 675 675 675 675 675 675 675 675 675 675 675 675 675 675 675 675 675 675 675 675 675 675 675 675 675 675 675 675 675 
675 675 675 675 675 675 675 675 675 675 675 675 675 675 675 675 675 675 675 675 675 675 675 675 675 675 675 675 675 675 675 675 675 675 675 675 675 675 675 675 675 675 675 675 675 675 675 675 675 675 
675 675 675 675 675 675 675 675 675 675 675 675 675 675 675 675 675 675 675 675 675 675 675 675 675 675 675 675 675 675 675 675 675 675 675 675 675 675 675 675 675 675 675 675 675 675 675 675 675 675 
675 675 675 675 675 675 675 675 675 675 675 675 675 675 675 675 675 675 675 675 675 675 675 675 675 675 675 675 675 675 675 675 675 675 675 675 675 675 675 675 675 675 675 675 675 675 675 675 675 675 
675 675 675 675 675 675 762 762 762 762 762 762 762 762 762 762 762 762 762 762 762 762 762 762 762 762 762 762 762 762 762 762 762 762 762 762 762 762 762 762 762 762 762 762 675 675 675 675 675 675 
675 675 675 675 675 675 762 762 762 762 762 762 762 762 762 762 762 762 762 762 762 762 762 762 762 762 762 762 762 762 762 762 762 762 762 762 762 762 762 762 762 762 762 762 675 675 675 675 675 675 
675 675 675 675 675 675 762 762 762 762 762 762 762 762 762 762 762 762 762 762 762 762 762 762 762 762 762 762 762 762 762 762 762 762 762 762 762 762 762 762 762 762 762 762 675 675 675 675 675 675 
675 675 675 675 675 675 762 762 762 762 762 762 762 762 762 762 762 762 762 762 762 762 762 762 762 762 762 762 762 762 762 762 762 762 762 762 762 762 762 4 4 4 762 762 675 675 675 675 675 675 
675 675 675 675 675 675 762 4 4 4 4 762 762 762 762 762 762 4 4 741 4 4 4 4 4 4 4 4 4 4 762 762 762 762 762 762 762 762 762 4 4 4 762 762 675 675 675 675 675 675 
675 675 675 675 675 675 762 4 4 701 4 762 762 762 762 762 762 4 762 762 762 762 762 762 762 762 762 762 762 4 762 762 762 762 762 762 762 762 762 4 4 4 762 762 675 675 675 675 675 675 
675 675 675 675 675 675 762 4 4 4 4 762 762 762 762 762 762 4 762 762 762 762 762 762 762 762 762 762 762 4 4 762 762 762 762 762 762 762 762 4 4 762 762 762 675 675 675 675 675 675 
675 675 675 675 675 675 762 762 762 762 739 762 762 762 762 762 762 4 762 762 762 762 762 762 762 762 762 762 762 4 4 762 762 762 762 762 762 762 762 762 4 762 762 762 675 675 675 675 675 675 
675 675 675 675 675 675 762 762 762 762 4 762 762 762 762 762 762 4 762 762 762 762 762 762 762 762 762 762 762 4 4 4 4 4 4 4 4 4 4 4 4 762 762 762 675 675 675 675 675 675 
675 675 675 675 675 675 762 762 762 762 4 4 762 762 762 4 4 4 762 762 762 762 762 762 762 762 762 762 762 4 4 762 762 762 762 762 762 762 762 762 762 762 762 762 675 675 675 675 675 675 
675 675 675 675 675 675 762 762 762 762 762 4 4 4 4 4 762 762 762 762 762 762 762 762 762 762 762 762 762 4 4 762 762 762 762 762 762 762 762 762 762 762 762 762 675 675 675 675 675 675 
675 675 675 675 675 675 762 762 762 762 762 762 762 762 762 762 762 762 762 762 762 762 762 762 762 762 762 762 762 4 4 762 762 762 762 762 762 762 762 762 762 762 762 762 675 675 675 675 675 675 
675 675 675 675 675 675 762 762 762 762 762 762 762 762 762 762 762 762 762 762 762 762 762 762 762 762 762 762 4 4 4 4 762 762 762 762 762 762 762 762 762 762 762 762 675 675 675 675 675 675 
675 675 675 675 675 675 762 762 762 762 762 762 762 762 762 762 762 762 762 762 762 762 762 762 762 762 762 4 4 4 4 4 4 762 762 762 762 762 762 762 762 762 762 762 675 675 675 675 675 675 
675 675 675 675 675 675 762 762 762 762 762 762 762 762 762 762 762 762 762 762 762 762 762 762 762 762 4 4 4 4 4 4 4 4 762 762 762 762 762 762 762 762 762 762 675 675 675 675 675 675 
675 675 675 675 675 675 762 762 762 762 762 762 762 762 762 762 762 762 762 762 762 762 762 762 762 4 4 4 4 4 739 4 4 4 4 762 762 762 762 762 762 762 762 762 675 675 675 675 675 675 
675 675 675 675 675 675 762 762 4 4 4 4 762 762 762 762 762 762 4 4 4 4 4 4 762 4 4 4 4 741 739 742 4 4 4 4 4 4 4 4 4 762 762 762 675 675 675 675 675 675 
675 675 675 675 675 675 762 762 4 4 742 4 4 4 4 4 4 4 4 762 762 762 762 4 4 4 4 4 4 4 743 4 4 4 4 762 762 762 762 762 4 762 762 762 675 675 675 675 675 675 
675 675 675 675 675 675 762 762 4 4 4 4 762 762 762 762 762 762 762 762 762 762 762 762 762 4 4 4 4 4 4 4 4 4 4 762 762 762 762 762 4 762 762 762 675 675 675 675 675 675 
675 675 675 675 675 675 762 762 762 762 762 762 762 762 762 762 762 762 762 762 762 762 762 762 762 762 4 4 4 4 4 4 4 4 762 762 762 762 762 762 4 4 762 762 675 675 675 675 675 675 
675 675 675 675 675 675 762 762 762 762 762 762 762 762 762 762 762 762 762 762 762 762 762 762 762 762 762 4 4 4 4 4 762 762 762 762 762 762 762 762 762 4 4 762 675 675 675 675 675 675 
675 675 675 675 675 675 762 762 762 762 762 762 762 762 762 762 762 762 762 762 762 762 762 762 762 762 762 762 762 4 4 762 762 762 762 762 762 762 762 762 762 762 4 762 675 675 675 675 675 675 
675 675 675 675 675 675 762 762 762 762 762 762 762 762 762 762 762 762 762 762 762 762 762 762 762 762 762 762 762 4 4 762 762 762 762 762 762 762 762 762 762 762 762 762 675 675 675 675 675 675 
675 675 675 675 675 675 762 762 762 762 762 762 762 762 762 762 762 762 762 762 762 762 762 762 762 762 762 762 762 4 4 762 762 762 762 762 762 762 762 762 762 762 762 762 675 675 675 675 675 675 
675 675 675 675 675 675 762 762 762 762 762 762 762 762 762 762 762 762 762 762 762 762 762 762 762 762 762 762 762 4 4 762 762 762 762 762 762 4 4 4 4 4 762 762 675 675 675 675 675 675 
675 675 675 675 675 675 762 762 762 762 762 762 762 762 762 762 4 4 4 4 742 4 4 4 4 762 762 762 762 4 4 762 762 762 762 762 762 4 762 762 762 4 762 762 675 675 675 675 675 675 
675 675 675 675 675 675 762 762 762 762 762 762 762 762 762 762 4 762 762 762 762 762 762 762 4 762 762 762 762 4 4 762 762 762 762 762 762 4 762 762 762 4 762 762 675 675 675 675 675 675 
675 675 675 675 675 675 762 762 762 762 762 762 762 762 762 762 4 762 762 762 762 762 762 762 4 762 762 762 762 4 4 762 762 762 762 762 762 4 762 762 762 762 762 762 675 675 675 675 675 675 
675 675 675 675 675 675 762 762 762 762 762 762 762 762 762 762 4 762 762 762 762 762 762 762 4 4 762 762 762 4 4 762 762 762 762 4 4 4 762 762 762 762 762 762 675 675 675 675 675 675 
675 675 675 675 675 675 762 762 762 762 762 762 762 762 762 4 739 4 762 762 762 762 762 762 4 4 4 4 762 4 4 762 762 4 4 4 4 4 762 762 762 762 762 762 675 675 675 675 675 675 
675 675 675 675 675 675 762 762 762 762 762 762 762 762 762 700 4 4 762 762 762 762 762 762 762 762 4 4 4 742 4 4 4 4 4 4 4 4 4 4 762 762 762 762 675 675 675 675 675 675 
675 675 675 675 675 675 762 762 762 762 762 762 762 762 762 4 4 4 762 762 762 762 762 762 762 762 762 762 762 762 762 762 762 4 4 4 4 4 762 762 762 762 762 762 675 675 675 675 675 675 
675 675 675 675 675 675 762 762 762 762 762 762 762 762 762 762 762 762 762 762 762 762 762 762 762 762 762 762 762 762 762 762 762 762 762 4 762 762 762 762 762 762 762 762 675 675 675 675 675 675 
675 675 675 675 675 675 762 762 762 762 762 762 762 762 762 762 762 762 762 762 762 762 762 762 762 762 762 762 762 762 762 762 762 762 762 4 762 762 762 762 762 762 762 762 675 675 675 675 675 675 
675 675 675 675 675 675 762 762 762 762 762 762 762 762 762 762 762 762 762 762 762 762 762 762 762 762 762 762 762 762 762 762 762 762 762 762 762 762 762 762 762 762 762 762 675 675 675 675 675 675 
675 675 675 675 675 675 675 675 675 675 675 675 675 675 675 675 675 675 675 675 675 675 675 675 675 675 675 675 675 675 675 675 675 675 675 675 675 675 675 675 675 675 675 675 675 675 675 675 675 675 
675 675 675 675 675 675 675 675 675 675 675 675 675 675 675 675 675 675 675 675 675 675 675 675 675 675 675 675 675 675 675 675 675 675 675 675 675 675 675 675 675 675 675 675 675 675 675 675 675 675 
675 675 675 675 675 675 675 675 675 675 675 675 675 675 675 675 675 675 675 675 675 675 675 675 675 675 675 675 675 675 675 675 675 675 675 675 675 675 675 675 675 675 675 675 675 675 675 675 675 675 
675 675 675 675 675 675 675 675 675 675 675 675 675 675 675 675 675 675 675 675 675 675 675 675 675 675 675 675 675 675 675 675 675 675 675 675 675 675 675 675 675 675 675 675 675 675 675 675 675 675 
675 675 675 675 675 675 675 675 675 675 675 675 675 675 675 675 675 675 675 675 675 675 675 675 675 675 675 675 675 675 675 675 675 675 675 675 675 675 675 675 675 675 675 675 675 675 675 675 675 675 
675 675 675 675 675 675 675 675 675 675 675 675 675 675 675 675 675 675 675 675 675 675 675 675 675 675 675 675 675 675 675 675 675 675 675 675 675 675 675 675 675 675 675 675 675 675 675 675 675 675 
