1 1 1 1 1 1 1 1 1 1 1 1 1 1 1 1 1 1 1 1 1 1 1 1 1 1 1 1 1 1 1 1 1 1 1 1 1 1 1 1 1 1 1 1 1 1 1 1 1 1 
1 1 1 1 1 1 1 1 1 1 1 1 1 1 1 1 1 1 1 1 1 1 1 1 1 1 1 1 1 1 1 1 1 1 1 1 1 1 1 1 1 1 1 1 1 1 1 1 1 1 
1 1 1 1 1 1 1 1 1 1 1 1 1 1 1 1 1 1 1 1 1 1 1 1 1 1 1 1 1 1 1 1 1 1 1 1 1 1 1 1 1 1 1 1 1 1 1 1 1 1 
1 1 1 1 1 1 1 1 1 1 1 1 1 1 1 1 1 1 1 1 1 1 1 1 1 1 1 1 1 1 1 1 1 1 1 1 1 1 1 1 1 1 1 1 1 1 1 1 1 1 
1 1 1 1 1 1 1 1 1 1 1 1 1 1 1 1 1 1 1 1 1 1 1 1 1 1 1 1 1 1 1 1 1 1 1 1 1 1 1 1 1 1 1 1 1 1 1 1 1 1 
1 1 1 1 1 1 1 1 1 1 1 1 1 1 1 1 1 1 1 1 1 1 1 1 1 1 1 1 1 1 1 1 1 1 1 1 1 1 1 1 1 1 1 1 1 1 1 1 1 1 
1 1 1 1 1 1 1 1 1 1 1 1 1 1 1 1 1 1 1 1 1 1 1 1 1 1 1 1 1 1 1 1 1 1 1 1 1 1 1 1 1 1 1 1 1 1 1 1 1 1 
1 1 1 1 1 1 1 1 1 1 1 1 1 1 1 1 1 1 1 1 1 1 1 1 1 1 1 1 1 1 1 1 1 1 1 1 1 1 1 1 1 1 1 1 1 1 1 1 1 1 
1 1 1 1 1 1 1 1 1 1 1 1 1 1 1 1 1 1 1 1 1 1 1 1 1 1 1 1 1 1 1 1 1 1 1 1 1 1 1 1 1 1 1 1 1 1 1 1 1 1 
1 1 1 1 1 1 1 1 18 17 17 17 17 17 17 17 17 17 17 17 17 17 17 17 17 17 17 17 17 17 17 17 17 17 17 17 17 17 17 17 17 21 1 1 1 1 1 1 1 1 
1 1 1 1 1 1 1 1 19 5 5 5 5 409 410 5 5 5 5 5 5 5 5 5 5 5 5 5 5 25 26 27 5 5 5 5 5 5 5 5 5 22 1 1 1 1 1 1 1 1 
1 1 1 1 1 1 1 1 19 5 5 5 5 417 418 5 5 5 5 5 402 5 5 5 404 5 5 5 5 29 4 30 5 5 5 5 5 5 5 5 5 22 1 1 1 1 1 1 1 1 
1 1 1 1 1 1 1 1 19 409 410 5 5 421 422 5 5 5 5 5 5 5 25 26 26 26 26 26 26 37 4 30 5 5 5 5 5 5 5 5 5 22 1 1 1 1 1 1 1 1 
1 1 1 1 1 1 1 1 19 417 418 5 5 5 5 401 5 5 5 5 5 5 29 4 4 4 4 4 4 4 4 30 5 5 5 5 5 5 5 5 5 22 1 1 1 1 1 1 1 1 
1 1 1 1 1 1 1 1 19 425 426 769 770 771 772 5 402 5 5 5 5 5 29 4 4 4 4 4 4 4 4 30 5 5 5 5 5 5 5 5 5 22 1 1 1 1 1 1 1 1 
1 1 1 1 1 1 1 1 19 5 5 773 774 775 776 5 5 409 410 5 5 5 29 4 31 34 34 34 34 34 34 35 5 5 5 5 5 5 5 5 5 22 1 1 1 1 1 1 1 1 
1 1 1 1 1 1 1 1 19 5 403 777 778 779 780 5 5 417 418 5 5 401 29 4 30 5 5 5 5 5 5 5 5 5 5 5 5 409 410 5 5 22 1 1 1 1 1 1 1 1 
1 1 1 1 1 1 1 1 19 400 5 781 782 783 784 5 5 425 426 5 5 5 29 4 30 5 5 5 5 5 5 5 5 5 5 5 5 417 418 5 5 22 1 1 1 1 1 1 1 1 
1 1 1 1 1 1 1 1 19 402 5 29 4 30 5 5 403 5 5 5 5 5 29 4 30 5 5 5 5 5 5 5 5 5 5 5 5 425 426 5 5 22 1 1 1 1 1 1 1 1 
1 1 1 1 1 1 1 1 19 409 410 29 4 30 402 5 5 5 402 5 5 403 29 4 30 5 5 51 52 7 53 5 10 9 9 9 9 13 5 5 5 22 1 1 1 1 1 1 1 1 
1 1 1 1 1 1 1 1 19 417 418 29 4 36 26 26 26 26 26 26 26 26 37 4 36 27 388 65 4 4 66 5 11 1 1 1 1 14 5 5 5 22 1 1 1 1 1 1 1 1 
1 1 1 1 1 1 1 1 19 421 422 29 4 4 4 4 4 4 4 4 4 4 4 4 4 4 4 4 4 4 66 6 11 1 1 1 1 14 5 5 5 22 1 1 1 1 1 1 1 1 
1 1 1 1 1 1 1 1 19 5 402 33 34 34 34 34 34 34 34 34 34 34 32 4 31 35 388 65 4 4 66 5 11 1 1 1 1 14 5 5 5 22 1 1 1 1 1 1 1 1 
1 1 1 1 1 1 1 1 19 5 5 5 5 5 5 5 5 5 5 5 403 5 29 4 30 5 5 75 76 76 77 5 12 16 16 16 16 15 409 410 5 22 1 1 1 1 1 1 1 1 
1 1 1 1 1 1 1 1 19 388 385 397 5 769 770 771 772 5 5 5 5 5 29 4 30 5 5 5 5 5 5 5 481 482 5 5 5 5 417 418 5 22 1 1 1 1 1 1 1 1 
1 1 1 1 1 1 1 1 19 382 399 397 5 773 774 775 776 5 5 5 5 5 29 4 30 5 5 5 5 5 5 5 489 490 5 5 5 5 421 422 5 22 1 1 1 1 1 1 1 1 
1 1 1 1 1 1 1 1 19 395 383 385 5 777 778 779 780 5 5 5 409 410 29 4 30 5 5 5 5 5 5 5 493 494 5 5 5 5 402 403 5 22 1 1 1 1 1 1 1 1 
1 1 1 1 1 1 1 1 19 5 5 5 5 781 782 783 784 5 5 5 417 418 29 4 30 5 5 5 5 5 5 405 406 409 410 409 410 409 410 5 5 22 1 1 1 1 1 1 1 1 
1 1 1 1 1 1 1 1 19 5 5 5 5 29 4 30 5 403 5 5 421 422 29 4 30 5 5 5 5 409 410 413 414 417 418 417 418 417 418 409 410 22 1 1 1 1 1 1 1 1 
1 1 1 1 1 1 1 1 19 5 5 5 5 29 4 30 5 5 5 5 5 5 29 4 30 5 5 5 5 417 418 421 422 421 422 425 426 421 422 417 418 22 1 1 1 1 1 1 1 1 
1 1 1 1 1 1 1 1 19 5 5 5 5 29 4 36 26 26 26 26 26 26 37 4 36 5 5 5 5 421 422 400 5 5 401 404 404 5 402 421 422 22 1 1 1 1 1 1 1 1 
1 1 1 1 1 1 1 1 19 5 25 26 26 37 4 4 4 4 4 4 4 4 4 4 4 86 86 86 86 5 5 5 5 5 5 4 5 4 5 481 482 22 1 1 1 1 1 1 1 1 
1 1 1 1 1 1 1 1 19 5 29 4 4 31 34 34 34 34 34 34 34 34 34 34 35 5 5 5 5 409 410 403 5 4 5 5 5 5 403 485 486 22 1 1 1 1 1 1 1 1 
1 1 1 1 1 1 1 1 19 5 29 4 4 30 5 5 5 5 5 5 5 5 5 5 5 5 5 5 5 417 418 5 402 404 401 4 400 4 5 493 494 22 1 1 1 1 1 1 1 1 
1 1 1 1 1 1 1 1 19 5 29 4 4 30 5 5 5 5 5 5 5 5 5 5 5 5 5 5 5 421 422 409 410 481 482 409 410 409 410 409 410 22 1 1 1 1 1 1 1 1 
1 1 1 1 1 1 1 1 19 5 33 388 388 35 5 5 5 5 5 5 5 5 5 5 5 5 5 5 5 5 401 413 414 485 486 413 414 413 414 413 414 22 1 1 1 1 1 1 1 1 
1 1 1 1 1 1 1 1 19 5 5 388 388 5 5 5 5 5 5 5 5 5 5 5 5 5 5 5 5 5 5 421 422 493 494 421 422 425 426 421 422 22 1 1 1 1 1 1 1 1 
1 1 1 1 1 1 1 1 20 24 24 24 24 24 24 24 24 24 24 24 24 24 24 24 24 24 24 24 24 24 24 24 24 24 24 24 24 24 24 24 24 23 1 1 1 1 1 1 1 1 
1 1 1 1 1 1 1 1 1 1 1 1 1 1 1 1 1 1 1 1 1 1 1 1 1 1 1 1 1 1 1 1 1 1 1 1 1 1 1 1 1 1 1 1 1 1 1 1 1 1 
1 1 1 1 1 1 1 1 1 1 1 1 1 1 1 1 1 1 1 1 1 1 1 1 1 1 1 1 1 1 1 1 1 1 1 1 1 1 1 1 1 1 1 1 1 1 1 1 1 1 
1 1 1 1 1 1 1 1 1 1 1 1 1 1 1 1 1 1 1 1 1 1 1 1 1 1 1 1 1 1 1 1 1 1 1 1 1 1 1 1 1 1 1 1 1 1 1 1 1 1 
1 1 1 1 1 1 1 1 1 1 1 1 1 1 1 1 1 1 1 1 1 1 1 1 1 1 1 1 1 1 1 1 1 1 1 1 1 1 1 1 1 1 1 1 1 1 1 1 1 1 
1 1 1 1 1 1 1 1 1 1 1 1 1 1 1 1 1 1 1 1 1 1 1 1 1 1 1 1 1 1 1 1 1 1 1 1 1 1 1 1 1 1 1 1 1 1 1 1 1 1 
1 1 1 1 1 1 1 1 1 1 1 1 1 1 1 1 1 1 1 1 1 1 1 1 1 1 1 1 1 1 1 1 1 1 1 1 1 1 1 1 1 1 1 1 1 1 1 1 1 1 
1 1 1 1 1 1 1 1 1 1 1 1 1 1 1 1 1 1 1 1 1 1 1 1 1 1 1 1 1 1 1 1 1 1 1 1 1 1 1 1 1 1 1 1 1 1 1 1 1 1 
1 1 1 1 1 1 1 1 1 1 1 1 1 1 1 1 1 1 1 1 1 1 1 1 1 1 1 1 1 1 1 1 1 1 1 1 1 1 1 1 1 1 1 1 1 1 1 1 1 1 
1 1 1 1 1 1 1 1 1 1 1 1 1 1 1 1 1 1 1 1 1 1 1 1 1 1 1 1 1 1 1 1 1 1 1 1 1 1 1 1 1 1 1 1 1 1 1 1 1 1 
1 1 1 1 1 1 1 1 1 1 1 1 1 1 1 1 1 1 1 1 1 1 1 1 1 1 1 1 1 1 1 1 1 1 1 1 1 1 1 1 1 1 1 1 1 1 1 1 1 1 
1 1 1 1 1 1 1 1 1 1 1 1 1 1 1 1 1 1 1 1 1 1 1 1 1 1 1 1 1 1 1 1 1 1 1 1 1 1 1 1 1 1 1 1 1 1 1 1 1 1 
1 1 1 1 1 1 1 1 1 1 1 1 1 1 1 1 1 1 1 1 1 1 1 1 1 1 1 1 1 1 1 1 1 1 1 1 1 1 1 1 1 1 1 1 1 1 1 1 1 1 
