1 1 1 1 1 1 1 1 1 1 1 1 1 1 1 1 1 1 1 1 1 1 1 1 1 1 1 1 1 1 1 1 1 1 1 1 1 1 1 1 1 1 1 1 1 1 1 1 1 1 
1 1 1 1 1 1 1 1 1 1 1 1 1 1 1 1 1 1 1 1 1 1 1 1 1 1 1 1 1 1 1 1 1 1 1 1 1 1 1 1 1 1 1 1 1 1 1 1 1 1 
1 1 1 1 1 1 1 1 1 1 1 1 1 1 1 1 1 1 1 1 1 1 1 1 1 1 1 1 1 1 1 1 1 1 1 1 1 1 1 1 1 1 1 1 1 1 1 1 1 1 
1 1 1 1 1 1 1 1 1 1 1 1 1 1 1 1 1 1 1 1 1 1 1 1 1 1 1 1 1 1 1 1 1 1 1 1 1 1 1 1 1 1 1 1 1 1 1 1 1 1 
1 1 1 1 1 1 1 1 1 1 1 1 1 1 1 1 1 1 1 1 1 1 1 1 1 1 1 1 1 1 1 1 1 1 1 1 1 1 1 1 1 1 1 1 1 1 1 1 1 1 
1 1 1 1 1 1 1 1 1 1 1 1 1 1 1 1 1 1 1 1 1 1 1 1 1 1 1 1 1 1 1 1 1 1 1 1 1 1 1 1 1 1 1 1 1 1 1 1 1 1 
1 1 1 1 1 1 1 1 1 1 1 1 1 1 1 1 1 1 1 1 1 1 1 1 1 1 1 1 1 1 1 1 1 1 1 1 1 1 1 1 1 1 1 1 1 1 1 1 1 1 
1 1 1 1 1 1 1 1 1 1 1 1 1 1 1 1 1 1 1 1 1 1 1 1 1 1 1 1 1 1 1 1 1 1 1 1 1 1 1 1 1 1 1 1 1 1 1 1 1 1 
1 1 1 1 1 1 1 1 1 1 1 1 1 1 1 1 1 1 1 1 1 1 1 1 1 1 1 1 1 1 1 1 1 1 1 1 1 1 1 1 1 1 1 1 1 1 1 1 1 1 
1 1 1 1 1 1 1 1 18 17 17 17 17 17 17 17 17 17 17 17 17 17 17 17 17 17 17 17 17 17 17 17 17 17 17 17 17 17 17 17 17 17 17 21 1 1 1 1 1 1 
1 1 1 1 1 1 1 1 19 5 5 5 5 5 5 5 5 5 5 5 5 5 5 5 5 5 5 5 294 295 5 5 5 5 5 5 657 658 658 660 5 5 5 22 1 1 1 1 1 1 
1 1 1 1 1 1 1 1 19 5 5 5 5 5 25 26 26 26 26 26 26 26 26 27 5 5 5 5 302 303 5 5 5 5 5 5 661 662 663 664 5 5 5 22 1 1 1 1 1 1 
1 1 1 1 1 1 1 1 19 5 5 5 5 5 29 4 4 4 4 4 4 4 4 30 5 5 5 5 310 311 5 5 5 5 5 5 665 666 667 668 5 5 5 22 1 1 1 1 1 1 
1 1 1 1 1 1 1 1 19 5 5 5 5 5 29 4 4 4 4 4 4 4 4 30 5 5 5 5 271 275 5 5 5 5 5 5 669 670 671 672 5 5 5 22 1 1 1 1 1 1 
1 1 1 1 1 1 1 1 19 5 5 5 5 5 29 4 4 4 4 4 4 4 4 36 26 26 26 26 26 26 26 26 26 26 26 26 37 4 30 5 5 5 5 22 1 1 1 1 1 1 
1 1 1 1 1 1 1 1 19 5 5 5 5 5 29 4 4 4 4 4 4 4 4 4 4 4 4 4 4 4 4 4 4 4 4 4 4 4 30 5 5 5 5 22 1 1 1 1 1 1 
1 1 1 1 1 1 1 1 19 5 5 5 5 5 29 4 4 4 4 4 4 4 4 4 4 4 4 4 4 4 4 4 31 34 34 34 34 34 35 5 5 5 5 22 1 1 1 1 1 1 
1 1 1 1 1 1 1 1 19 5 5 5 5 5 33 34 34 34 34 34 34 34 34 34 34 34 34 34 34 32 4 4 30 5 10 9 9 9 9 9 13 5 5 22 1 1 1 1 1 1 
1 1 1 1 1 1 1 1 19 5 5 5 5 5 5 5 294 295 5 5 5 5 5 5 5 5 5 5 5 29 4 4 30 5 11 1 1 1 1 1 14 5 5 22 1 1 1 1 1 1 
1 1 1 1 1 1 1 1 19 5 5 5 5 5 5 5 306 307 5 292 274 5 5 5 5 5 5 5 5 29 4 4 30 5 11 1 1 1 1 1 14 5 5 22 1 1 1 1 1 1 
1 1 1 1 1 1 1 1 19 5 5 5 5 5 5 5 310 311 5 277 271 5 5 5 5 5 5 7 5 29 4 4 30 5 11 1 1 1 1 1 14 5 5 22 1 1 1 1 1 1 
1 1 1 1 1 1 1 1 19 5 5 5 5 5 5 5 5 5 5 293 292 5 370 371 5 5 5 5 5 29 4 4 30 5 11 1 1 1 1 1 14 5 5 22 1 1 1 1 1 1 
1 1 1 1 1 1 1 1 19 5 5 5 5 5 5 5 5 657 658 659 660 5 374 375 5 5 5 5 5 29 4 4 30 5 12 16 16 16 16 16 15 5 5 22 1 1 1 1 1 1 
1 1 1 1 1 1 1 1 19 5 5 5 5 5 294 295 5 661 662 663 664 5 386 387 5 5 5 5 5 29 4 4 30 5 5 5 5 5 5 5 5 5 5 22 1 1 1 1 1 1 
1 1 1 1 1 1 1 1 19 5 5 5 5 5 306 307 5 665 666 667 668 5 5 5 5 5 5 5 5 29 4 4 30 5 5 5 5 5 5 5 5 5 5 22 1 1 1 1 1 1 
1 1 1 1 1 1 1 1 19 5 5 5 5 5 314 315 5 669 670 671 672 5 5 5 5 5 5 5 5 29 4 4 30 5 5 5 5 5 5 5 5 5 5 22 1 1 1 1 1 1 
1 1 1 1 1 1 1 1 19 5 5 5 5 5 5 5 29 4 4 4 30 5 5 5 5 5 5 5 5 29 4 4 30 5 5 5 5 5 294 295 294 295 5 22 1 1 1 1 1 1 
1 1 1 1 1 1 1 1 19 5 5 5 5 5 5 5 29 4 4 4 30 5 5 5 5 5 5 5 5 29 4 4 30 5 5 5 294 295 306 307 302 303 5 22 1 1 1 1 1 1 
1 1 1 1 1 1 1 1 19 5 5 5 5 5 5 5 33 32 4 4 30 5 5 5 5 5 5 5 5 29 4 4 30 5 294 295 302 303 310 311 310 311 5 22 1 1 1 1 1 1 
1 1 1 1 1 1 1 1 19 5 5 5 5 5 5 5 5 29 4 4 36 26 26 26 26 26 26 26 26 37 4 4 30 5 302 303 310 311 5 5 5 294 295 22 1 1 1 1 1 1 
1 1 1 1 1 1 1 1 19 5 5 5 5 5 5 5 5 29 4 4 4 4 4 4 4 4 4 4 4 4 4 4 36 26 310 311 5 289 287 289 289 306 307 22 1 1 1 1 1 1 
1 1 1 1 1 1 1 1 19 5 5 5 5 5 5 5 5 29 4 4 4 4 4 4 4 4 4 4 4 4 4 4 4 4 4 4 5 291 291 293 289 310 311 22 1 1 1 1 1 1 
1 1 1 1 1 1 1 1 19 5 5 5 5 5 5 5 5 29 4 4 4 31 34 34 34 34 34 34 34 34 34 34 32 4 4 4 5 292 291 289 287 294 295 22 1 1 1 1 1 1 
1 1 1 1 1 1 1 1 19 5 5 5 5 5 5 5 5 29 4 4 4 30 5 5 5 5 5 5 5 5 5 5 33 34 4 4 5 293 292 292 289 306 307 22 1 1 1 1 1 1 
1 1 1 1 1 1 1 1 19 5 5 5 5 5 5 5 5 29 4 4 4 30 5 5 5 5 5 5 5 5 5 5 5 5 294 295 5 292 280 293 293 310 311 22 1 1 1 1 1 1 
1 1 1 1 1 1 1 1 19 5 5 5 5 5 5 5 5 29 4 4 4 30 5 5 5 5 5 5 5 5 5 5 5 5 302 303 294 295 294 295 294 295 5 22 1 1 1 1 1 1 
1 1 1 1 1 1 1 1 19 5 5 5 5 5 5 277 744 745 745 745 745 745 746 271 5 5 5 5 5 5 5 5 5 5 310 311 302 303 302 303 302 303 5 22 1 1 1 1 1 1 
1 1 1 1 1 1 1 1 19 5 5 5 5 5 5 281 751 750 747 748 749 750 752 272 5 5 5 5 5 5 5 5 5 5 5 5 310 311 310 311 310 311 5 22 1 1 1 1 1 1 
1 1 1 1 1 1 1 1 19 5 5 5 5 5 5 286 751 750 753 750 751 750 752 278 5 5 5 5 5 5 5 5 5 5 5 5 5 5 5 5 5 5 5 22 1 1 1 1 1 1 
1 1 1 1 1 1 1 1 19 5 5 5 5 5 5 273 751 750 758 759 760 750 752 286 5 5 5 5 5 5 5 5 5 5 5 5 5 5 5 5 5 5 5 22 1 1 1 1 1 1 
1 1 1 1 1 1 1 1 19 5 5 5 5 5 5 280 755 756 756 756 756 756 757 272 5 5 5 5 5 5 5 5 5 5 5 5 5 5 5 5 5 5 5 22 1 1 1 1 1 1 
1 1 1 1 1 1 1 1 20 24 24 24 24 24 24 24 24 24 24 24 24 24 24 24 24 24 24 24 24 24 24 24 24 24 24 24 24 24 24 24 24 24 24 23 1 1 1 1 1 1 
1 1 1 1 1 1 1 1 1 1 1 1 1 1 1 1 1 1 1 1 1 1 1 1 1 1 1 1 1 1 1 1 1 1 1 1 1 1 1 1 1 1 1 1 1 1 1 1 1 1 
1 1 1 1 1 1 1 1 1 1 1 1 1 1 1 1 1 1 1 1 1 1 1 1 1 1 1 1 1 1 1 1 1 1 1 1 1 1 1 1 1 1 1 1 1 1 1 1 1 1 
1 1 1 1 1 1 1 1 1 1 1 1 1 1 1 1 1 1 1 1 1 1 1 1 1 1 1 1 1 1 1 1 1 1 1 1 1 1 1 1 1 1 1 1 1 1 1 1 1 1 
1 1 1 1 1 1 1 1 1 1 1 1 1 1 1 1 1 1 1 1 1 1 1 1 1 1 1 1 1 1 1 1 1 1 1 1 1 1 1 1 1 1 1 1 1 1 1 1 1 1 
1 1 1 1 1 1 1 1 1 1 1 1 1 1 1 1 1 1 1 1 1 1 1 1 1 1 1 1 1 1 1 1 1 1 1 1 1 1 1 1 1 1 1 1 1 1 1 1 1 1 
1 1 1 1 1 1 1 1 1 1 1 1 1 1 1 1 1 1 1 1 1 1 1 1 1 1 1 1 1 1 1 1 1 1 1 1 1 1 1 1 1 1 1 1 1 1 1 1 1 1 
1 1 1 1 1 1 1 1 1 1 1 1 1 1 1 1 1 1 1 1 1 1 1 1 1 1 1 1 1 1 1 1 1 1 1 1 1 1 1 1 1 1 1 1 1 1 1 1 1 1 
1 1 1 1 1 1 1 1 1 1 1 1 1 1 1 1 1 1 1 1 1 1 1 1 1 1 1 1 1 1 1 1 1 1 1 1 1 1 1 1 1 1 1 1 1 1 1 1 1 1 
